"","station_id","station_name","lat","long","start_n","end_n","e_start_n","e_end_n","c_start_n","c_end_n","total","classic","electric"
"1",2,"Buckingham Fountain",41.8765,-87.6205,1161,1127,0,0,1161,1127,2288,2288,0
"2",3,"Shedd Aquarium",41.8672,-87.6154,46,40,0,0,46,40,86,86,0
"3",4,"Burnham Harbor",41.8563,-87.6133,3,2,0,0,3,2,5,5,0
"4",5,"State St & Harrison St",41.8741,-87.6277,353,363,0,0,353,363,716,716,0
"5",6,"Dusable Harbor",41.887,-87.6128,68,50,0,0,68,50,118,118,0
"6",7,"Field Blvd & South Water St",41.8863,-87.6175,464,442,0,0,464,442,906,906,0
"7",9,"Leavitt St & Archer Ave",41.8288,-87.6806,85,82,0,0,85,82,167,167,0
"8",11,"Jeffery Blvd & 71st St",41.7666,-87.5764,90,91,0,0,90,91,181,181,0
"9",12,"South Shore Dr & 71st St",41.7664,-87.5657,176,171,0,0,176,171,347,347,0
"10",13,"Wilton Ave & Diversey Pkwy",41.9324,-87.6527,652,623,0,0,652,623,1275,1275,0
"11",14,"Morgan St & 18th St",41.8581,-87.6511,258,261,0,0,258,261,519,519,0
"12",15,"Racine Ave & 18th St",41.8582,-87.6565,335,356,0,0,335,356,691,691,0
"13",16,"Paulina Ave & North Ave",41.9103,-87.6701,446,497,0,0,446,497,943,943,0
"14",17,"Honore St & Division St",41.9031,-87.6739,577,568,0,0,577,568,1145,1145,0
"15",18,"Wacker Dr & Washington St",41.8831,-87.6373,287,272,0,0,287,272,559,559,0
"16",19,"Throop (Loomis) St & Taylor St",41.869,-87.6591,261,253,0,0,261,253,514,514,0
"17",20,"Sheffield Ave & Kingsbury St",41.9105,-87.6531,506,504,0,0,506,504,1010,1010,0
"18",21,"Aberdeen St & Jackson Blvd",41.8777,-87.6548,661,647,0,0,661,647,1308,1308,0
"19",22,"May St & Taylor St",41.8695,-87.6555,448,464,0,0,448,464,912,912,0
"20",23,"Orleans St & Elm St",41.9029,-87.6377,269,250,0,0,269,250,519,519,0
"21",24,"Fairbanks Ct & Grand Ave",41.8918,-87.6206,1109,1097,0,0,1109,1097,2206,2206,0
"22",25,"Michigan Ave & Pearson St",41.8977,-87.6235,349,323,0,0,349,323,672,672,0
"23",26,"McClurg Ct & Illinois St",41.8904,-87.6175,1001,1008,0,0,1001,1008,2009,2009,0
"24",27,"Larrabee St & North Ave",41.9102,-87.6435,373,341,0,0,373,341,714,714,0
"25",28,"Larrabee St & Menomonee St",41.9147,-87.6433,318,296,0,0,318,296,614,614,0
"26",29,"Noble St & Milwaukee Ave",41.9007,-87.6626,512,512,0,0,512,512,1024,1024,0
"27",30,"Ashland Ave & Augusta Blvd",41.8996,-87.6677,407,391,0,0,407,391,798,798,0
"28",31,"Franklin St & Chicago Ave",41.8967,-87.6357,517,472,0,0,517,472,989,989,0
"29",32,"Racine Ave & Congress Pkwy",41.8746,-87.657,119,123,0,0,119,123,242,242,0
"30",33,"State St & Van Buren St",41.8772,-87.6278,311,306,0,0,311,306,617,617,0
"31",34,"Cannon Dr & Fullerton Ave",41.9268,-87.6344,686,661,0,0,686,661,1347,1347,0
"32",35,"Streeter Dr & Grand Ave",41.8923,-87.612,613,558,0,0,613,558,1171,1171,0
"33",36,"Franklin St & Jackson Blvd",41.8777,-87.6353,546,528,0,0,546,528,1074,1074,0
"34",37,"Dearborn St & Adams St",41.8794,-87.6298,272,237,0,0,272,237,509,509,0
"35",38,"Clark St & Lake St",41.886,-87.6309,723,713,0,0,723,713,1436,1436,0
"36",39,"Wabash Ave & Adams St",41.8795,-87.6257,397,385,0,0,397,385,782,782,0
"37",40,"LaSalle St & Adams St",41.8793,-87.632,179,139,0,0,179,139,318,318,0
"38",41,"Federal St & Polk St",41.8721,-87.6295,809,838,0,0,809,838,1647,1647,0
"39",42,"Wabash Ave & Cermak Rd",41.8526,-87.6265,154,178,0,0,154,178,332,332,0
"40",43,"Michigan Ave & Washington St",41.884,-87.6247,852,868,0,0,852,868,1720,1720,0
"41",44,"State St & Randolph St",41.8847,-87.6277,733,752,0,0,733,752,1485,1485,0
"42",45,"Michigan Ave & Ida B Wells Dr",41.8762,-87.6244,291,277,0,0,291,277,568,568,0
"43",46,"Wells St & Walton St",41.8999,-87.6344,448,407,0,0,448,407,855,855,0
"44",47,"State St & Kinzie St",41.8892,-87.6278,578,581,0,0,578,581,1159,1159,0
"45",48,"Larrabee St & Kingsbury St",41.8978,-87.6429,430,414,0,0,430,414,844,844,0
"46",49,"Dearborn St & Monroe St",41.8813,-87.6295,708,705,0,0,708,705,1413,1413,0
"47",50,"Clark St & Ida B Wells Dr",41.8759,-87.6306,226,227,0,0,226,227,453,453,0
"48",51,"Clark St & Randolph St",41.8846,-87.6319,600,586,0,0,600,586,1186,1186,0
"49",52,"Michigan Ave & Lake St",41.886,-87.6241,1048,987,0,0,1048,987,2035,2035,0
"50",53,"Wells St & Huron St",41.8947,-87.6344,1401,1340,0,0,1401,1340,2741,2741,0
"51",54,"Ogden Ave & Chicago Ave",41.8964,-87.6541,553,561,0,0,553,561,1114,1114,0
"52",55,"Halsted St & Roosevelt Rd",41.8673,-87.6486,138,116,0,0,138,116,254,254,0
"53",56,"Desplaines St & Kinzie St",41.8887,-87.6444,1372,1256,0,0,1372,1256,2628,2628,0
"54",57,"Clinton St & Roosevelt Rd",41.8671,-87.6411,531,616,0,0,531,616,1147,1147,0
"55",58,"Marshfield Ave & Cortland St",41.916,-87.6689,305,279,0,0,305,279,584,584,0
"56",59,"Wabash Ave & Roosevelt Rd",41.8672,-87.626,1301,1499,0,0,1301,1499,2800,2800,0
"57",60,"Dayton St & North Ave",41.9106,-87.6494,431,433,0,0,431,433,864,864,0
"58",61,"Wood St & Milwaukee Ave",41.9077,-87.6726,695,723,0,0,695,723,1418,1418,0
"59",62,"McCormick Place",41.8514,-87.6188,216,208,0,0,216,208,424,424,0
"60",66,"Clinton St & Lake St",41.8856,-87.6418,656,659,0,0,656,659,1315,1315,0
"61",67,"Sheffield Ave & Fullerton Ave",41.9256,-87.6537,637,580,0,0,637,580,1217,1217,0
"62",68,"Clinton St & Tilden St",41.8759,-87.6408,188,186,0,0,188,186,374,374,0
"63",69,"Damen Ave & Pierce Ave",41.9094,-87.6777,971,1037,0,0,971,1037,2008,2008,0
"64",71,"Morgan St & Lake St",41.8855,-87.6523,665,790,0,0,665,790,1455,1455,0
"65",72,"Wabash Ave & 16th St",41.8604,-87.6258,595,570,0,0,595,570,1165,1165,0
"66",73,"Jefferson St & Monroe St",41.8804,-87.6427,525,441,0,0,525,441,966,966,0
"67",74,"Kingsbury St & Erie St",41.8938,-87.6417,1102,1108,0,0,1102,1108,2210,2210,0
"68",75,"Canal St & Jackson Blvd",41.8772,-87.6394,124,129,0,0,124,129,253,253,0
"69",76,"Lake Shore Dr & Monroe St",41.881,-87.6167,209,191,0,0,209,191,400,400,0
"70",77,"Clinton St & Madison St",41.8822,-87.6411,617,599,0,0,617,599,1216,1216,0
"71",80,"Aberdeen St & Monroe St",41.8804,-87.6555,384,401,0,0,384,401,785,785,0
"72",81,"Daley Center Plaza",41.8842,-87.6296,594,528,0,0,594,528,1122,1122,0
"73",84,"Milwaukee Ave & Grand Ave",41.8916,-87.6484,799,802,0,0,799,802,1601,1601,0
"74",85,"Michigan Ave & Oak St",41.901,-87.6238,541,500,0,0,541,500,1041,1041,0
"75",86,"Eckhart Park",41.8964,-87.661,598,583,0,0,598,583,1181,1181,0
"76",87,"Racine Ave & Fullerton Ave",41.9256,-87.6584,527,531,0,0,527,531,1058,1058,0
"77",88,"Racine Ave & Randolph St",41.8841,-87.6569,259,244,0,0,259,244,503,503,0
"78",89,"Financial Pl & Ida B Wells Dr",41.875,-87.6331,280,262,0,0,280,262,542,542,0
"79",90,"Millennium Park",41.881,-87.6241,1212,1178,0,0,1212,1178,2390,2390,0
"80",91,"Clinton St & Washington Blvd",41.8834,-87.6412,452,453,0,0,452,453,905,905,0
"81",92,"Carpenter St & Huron St",41.8946,-87.6534,510,477,0,0,510,477,987,987,0
"82",93,"Sheffield Ave & Willow St",41.9137,-87.6529,643,677,0,0,643,677,1320,1320,0
"83",94,"Clark St & Armitage Ave",41.9183,-87.6363,1405,1385,0,0,1405,1385,2790,2790,0
"84",95,"Stony Island Ave & 64th St",41.7789,-87.5866,33,28,0,0,33,28,61,61,0
"85",96,"Desplaines St & Randolph St",41.8846,-87.6446,554,581,0,0,554,581,1135,1135,0
"86",97,"Field Museum",41.8653,-87.6179,46,37,0,0,46,37,83,83,0
"87",98,"LaSalle St & Washington St",41.8827,-87.6325,481,508,0,0,481,508,989,989,0
"88",99,"Lake Shore Dr & Ohio St",41.8926,-87.6145,581,544,0,0,581,544,1125,1125,0
"89",100,"Orleans St & Merchandise Mart Plaza",41.8882,-87.6364,356,315,0,0,356,315,671,671,0
"90",101,"63rd St Beach",41.781,-87.5761,135,129,0,0,135,129,264,264,0
"91",102,"Stony Island Ave & 67th St",41.7735,-87.5853,65,64,0,0,65,64,129,129,0
"92",103,"Clinton St & Polk St",41.8715,-87.6409,48,48,0,0,48,48,96,96,0
"93",106,"State St & Pearson St",41.8974,-87.6287,569,571,0,0,569,571,1140,1140,0
"94",107,"Desplaines St & Jackson Blvd",41.8783,-87.6439,686,649,0,0,686,649,1335,1335,0
"95",108,"Halsted St & Polk St",41.8718,-87.6466,131,128,0,0,131,128,259,259,0
"96",109,"900 W Harrison St",41.8748,-87.6498,275,263,0,0,275,263,538,538,0
"97",110,"Dearborn St & Erie St",41.894,-87.6293,1483,1492,0,0,1483,1492,2975,2975,0
"98",111,"Sedgwick St & Huron St",41.8947,-87.6384,378,365,0,0,378,365,743,743,0
"99",112,"Green St & Randolph St",41.8837,-87.6487,482,508,0,0,482,508,990,990,0
"100",113,"Bissell St & Armitage Ave",41.9184,-87.6522,859,908,0,0,859,908,1767,1767,0
"101",114,"Sheffield Ave & Waveland Ave",41.9494,-87.6545,1124,1166,0,0,1124,1166,2290,2290,0
"102",115,"Sheffield Ave & Wellington Ave",41.9363,-87.6527,851,876,0,0,851,876,1727,1727,0
"103",116,"Western Ave & Winnebago Ave",41.9155,-87.687,531,531,0,0,531,531,1062,1062,0
"104",117,"Wilton Ave & Belmont Ave",41.9402,-87.653,1252,1225,0,0,1252,1225,2477,2477,0
"105",118,"Sedgwick St & North Ave",41.9114,-87.6387,646,627,0,0,646,627,1273,1273,0
"106",119,"Ashland Ave & Lake St",41.8859,-87.6672,243,222,0,0,243,222,465,465,0
"107",120,"Wentworth Ave & Cermak Rd (Temp)",41.853,-87.6306,229,243,0,0,229,243,472,472,0
"108",121,"Blackstone Ave & Hyde Park Blvd",41.8026,-87.5904,317,315,0,0,317,315,632,632,0
"109",122,"Ogden Ave & Congress Pkwy",41.875,-87.6733,87,91,0,0,87,91,178,178,0
"110",123,"California Ave & Milwaukee Ave",41.9227,-87.6972,586,566,0,0,586,566,1152,1152,0
"111",124,"Damen Ave & Cullerton St",41.855,-87.6757,286,304,0,0,286,304,590,590,0
"112",125,"Rush St & Hubbard St",41.8902,-87.6262,332,308,0,0,332,308,640,640,0
"113",126,"Clark St & North Ave",41.912,-87.6319,807,803,0,0,807,803,1610,1610,0
"114",127,"Lincoln Ave & Fullerton Ave",41.9259,-87.6493,951,961,0,0,951,961,1912,1912,0
"115",128,"Damen Ave & Chicago Ave",41.8958,-87.6772,757,797,0,0,757,797,1554,1554,0
"116",129,"Blue Island Ave & 18th St",41.8576,-87.6615,290,373,0,0,290,373,663,663,0
"117",130,"Damen Ave & Division St",41.9033,-87.6784,494,427,0,0,494,427,921,921,0
"118",131,"Lincoln Ave & Belmont Ave",41.9394,-87.6684,467,503,0,0,467,503,970,970,0
"119",132,"Wentworth Ave & 24th St (Temp)",41.8501,-87.6321,113,141,0,0,113,141,254,254,0
"120",133,"Kingsbury St & Kinzie St",41.8892,-87.6385,907,881,0,0,907,881,1788,1788,0
"121",134,"Peoria St & Jackson Blvd",41.8776,-87.6496,677,652,0,0,677,652,1329,1329,0
"122",135,"Halsted St & 21st St",41.8538,-87.6466,116,126,0,0,116,126,242,242,0
"123",136,"Racine Ave & 13th St",41.8651,-87.657,74,90,0,0,74,90,164,164,0
"124",137,"Morgan Ave & 14th Pl",41.8624,-87.6511,200,211,0,0,200,211,411,411,0
"125",138,"Clybourn Ave & Division St",41.9046,-87.6406,360,376,0,0,360,376,736,736,0
"126",140,"Dearborn Pkwy & Delaware Pl",41.899,-87.6299,1413,1471,0,0,1413,1471,2884,2884,0
"127",141,"Clark St & Lincoln Ave",41.9157,-87.6346,1476,1424,0,0,1476,1424,2900,2900,0
"128",142,"McClurg Ct & Erie St",41.8945,-87.6179,842,832,0,0,842,832,1674,1674,0
"129",143,"Sedgwick St & Webster Ave",41.9222,-87.6389,697,663,0,0,697,663,1360,1360,0
"130",144,"Larrabee St & Webster Ave",41.9218,-87.6441,1549,1601,0,0,1549,1601,3150,3150,0
"131",145,"Mies van der Rohe Way & Chestnut St",41.8986,-87.6219,771,734,0,0,771,734,1505,1505,0
"132",146,"Loomis St & Jackson Blvd",41.8779,-87.662,354,389,0,0,354,389,743,743,0
"133",147,"Indiana Ave & 26th St",41.8457,-87.6225,269,263,0,0,269,263,532,532,0
"134",148,"State St & 33rd St",41.8347,-87.6258,311,295,0,0,311,295,606,606,0
"135",149,"Calumet Ave & 33rd St",41.8349,-87.6179,271,264,0,0,271,264,535,535,0
"136",150,"Fort Dearborn Dr & 31st St",41.8386,-87.6082,125,110,0,0,125,110,235,235,0
"137",152,"Lincoln Ave & Diversey Pkwy",41.9322,-87.6586,519,531,0,0,519,531,1050,1050,0
"138",153,"Southport Ave & Wellington Ave",41.9357,-87.6636,603,639,0,0,603,639,1242,1242,0
"139",154,"Southport Ave & Belmont Ave",41.9395,-87.6638,373,404,0,0,373,404,777,777,0
"140",156,"Clark St & Wellington Ave",41.9365,-87.6475,954,983,0,0,954,983,1937,1937,0
"141",157,"Lake Shore Dr & Wellington Ave",41.9367,-87.6368,959,933,0,0,959,933,1892,1892,0
"142",158,"Milwaukee Ave & Wabansia Ave",41.9126,-87.6814,704,726,0,0,704,726,1430,1430,0
"143",159,"Claremont Ave & Hirsch St",41.9078,-87.6859,144,113,0,0,144,113,257,257,0
"144",160,"Campbell Ave & North Ave",41.9105,-87.6896,348,341,0,0,348,341,689,689,0
"145",161,"Rush St & Superior St",41.8958,-87.6259,672,596,0,0,672,596,1268,1268,0
"146",162,"Damen Ave & Wellington Ave",41.9359,-87.6784,370,380,0,0,370,380,750,750,0
"147",163,"Damen Ave & Clybourn Ave",41.9319,-87.6779,333,383,0,0,333,383,716,716,0
"148",164,"Franklin St & Lake St",41.8858,-87.6355,543,514,0,0,543,514,1057,1057,0
"149",165,"Clark St & Grace St",41.9508,-87.6592,858,863,0,0,858,863,1721,1721,0
"150",166,"Ashland Ave & Wrightwood Ave",41.9288,-87.6685,333,340,0,0,333,340,673,673,0
"151",167,"Damen Ave & Coulter St",41.8492,-87.6756,54,57,0,0,54,57,111,111,0
"152",168,"Michigan Ave & 14th St",41.8641,-87.6237,716,671,0,0,716,671,1387,1387,0
"153",169,"Canal St & Harrison St",41.8743,-87.6396,122,115,0,0,122,115,237,237,0
"154",170,"Clinton St & 18th St",41.858,-87.6408,137,138,0,0,137,138,275,275,0
"155",171,"May St & Cullerton St",41.8551,-87.6541,99,100,0,0,99,100,199,199,0
"156",172,"Rush St & Cedar St",41.9023,-87.6277,868,888,0,0,868,888,1756,1756,0
"157",173,"Mies van der Rohe Way & Chicago Ave",41.8969,-87.6217,864,720,0,0,864,720,1584,1584,0
"158",174,"Canal St & Madison St",41.8821,-87.6398,292,256,0,0,292,256,548,548,0
"159",175,"Wells St & Polk St",41.8726,-87.6335,574,574,0,0,574,574,1148,1148,0
"160",176,"Clark St & Elm St",41.903,-87.6313,1944,1954,0,0,1944,1954,3898,3898,0
"161",177,"Theater on the Lake",41.9263,-87.6308,94,89,0,0,94,89,183,183,0
"162",178,"State St & 19th St",41.8566,-87.6275,284,287,0,0,284,287,571,571,0
"163",179,"MLK Jr Dr & Pershing Rd",41.8246,-87.6168,251,250,0,0,251,250,501,501,0
"164",180,"Ritchie Ct & Banks St",41.9069,-87.6262,716,664,0,0,716,664,1380,1380,0
"165",181,"LaSalle St & Illinois St",41.8908,-87.6317,710,695,0,0,710,695,1405,1405,0
"166",182,"Wells St & Elm St",41.9032,-87.6343,1328,1234,0,0,1328,1234,2562,2562,0
"167",183,"Damen Ave & Thomas St (Augusta Blvd)",41.9013,-87.6774,502,486,0,0,502,486,988,988,0
"168",184,"State St & 35th St",41.8309,-87.628,129,123,0,0,129,123,252,252,0
"169",185,"Stave St & Armitage Ave",41.9177,-87.6914,203,211,0,0,203,211,414,414,0
"170",186,"Ogden Ave & Race Ave",41.8918,-87.6588,428,438,0,0,428,438,866,866,0
"171",188,"Greenview Ave & Fullerton Ave",41.9253,-87.6658,549,532,0,0,549,532,1081,1081,0
"172",190,"Southport Ave & Wrightwood Ave",41.9288,-87.6639,401,427,0,0,401,427,828,828,0
"173",191,"Canal St & Monroe St",41.8817,-87.6395,143,109,0,0,143,109,252,252,0
"174",192,"Canal St & Adams St",41.8793,-87.6399,384,357,0,0,384,357,741,741,0
"175",193,"State St & 29th St",41.8417,-87.6269,62,62,0,0,62,62,124,124,0
"176",194,"Wabash Ave & Wacker Pl",41.8869,-87.626,680,685,0,0,680,685,1365,1365,0
"177",195,"Columbus Dr & Randolph St",41.8847,-87.6195,1256,1032,0,0,1256,1032,2288,2288,0
"178",196,"Cityfront Plaza Dr & Pioneer Ct",41.8906,-87.6221,641,587,0,0,641,587,1228,1228,0
"179",197,"Michigan Ave & Madison St",41.8821,-87.6251,422,416,0,0,422,416,838,838,0
"180",198,"Green St & Madison St",41.8819,-87.6488,1007,1112,0,0,1007,1112,2119,2119,0
"181",199,"Wabash Ave & Grand Ave",41.8915,-87.6268,1352,1367,0,0,1352,1367,2719,2719,0
"182",200,"MLK Jr Dr & 47th St",41.8099,-87.6163,95,103,0,0,95,103,198,198,0
"183",201,"Indiana Ave & 40th St",41.8217,-87.6216,31,32,0,0,31,32,63,63,0
"184",202,"Halsted St & 18th St",41.8575,-87.6463,214,225,0,0,214,225,439,439,0
"185",203,"Western Ave & 21st St",41.8541,-87.6858,83,99,0,0,83,99,182,182,0
"186",204,"Prairie Ave & Garfield Blvd",41.7949,-87.6187,60,51,0,0,60,51,111,111,0
"187",205,"Paulina St & 18th St",41.8579,-87.6687,342,358,0,0,342,358,700,700,0
"188",206,"Halsted St & Archer Ave",41.8472,-87.6468,129,133,0,0,129,133,262,262,0
"189",207,"Emerald Ave & 28th St",41.8436,-87.6454,201,196,0,0,201,196,397,397,0
"190",208,"Laflin St & Cullerton St",41.8549,-87.6636,235,282,0,0,235,282,517,517,0
"191",209,"Normal Ave & Archer Ave",41.8495,-87.6406,72,76,0,0,72,76,148,148,0
"192",210,"Ashland Ave & Division St",41.9035,-87.6677,1122,1251,0,0,1122,1251,2373,2373,0
"193",211,"St. Clair St & Erie St",41.8944,-87.6227,1255,1272,0,0,1255,1272,2527,2527,0
"194",212,"Wells St & Hubbard St",41.8899,-87.6343,909,877,0,0,909,877,1786,1786,0
"195",213,"Leavitt St & North Ave",41.9102,-87.6823,358,357,0,0,358,357,715,715,0
"196",214,"Damen Ave & Grand Ave",41.8912,-87.6769,324,295,0,0,324,295,619,619,0
"197",215,"Damen Ave & Madison St",41.8814,-87.6749,133,136,0,0,133,136,269,269,0
"198",216,"California Ave & Division St",41.903,-87.6975,438,471,0,0,438,471,909,909,0
"199",217,"Elizabeth (May) St & Fulton St",41.8866,-87.658,253,259,0,0,253,259,512,512,0
"200",218,"Wells St & 19th St",41.8568,-87.6339,15,17,0,0,15,17,32,32,0
"201",219,"Damen Ave & Cortland St",41.916,-87.6773,653,666,0,0,653,666,1319,1319,0
"202",220,"Clark St & Drummond Pl",41.9312,-87.6443,1040,1154,0,0,1040,1154,2194,2194,0
"203",222,"Milwaukee Ave & Rockwell St",41.9202,-87.693,278,281,0,0,278,281,559,559,0
"204",223,"Clifton Ave & Armitage Ave",41.9182,-87.6569,482,433,0,0,482,433,915,915,0
"205",224,"Halsted St & Willow St",41.9139,-87.6488,540,560,0,0,540,560,1100,1100,0
"206",225,"Halsted St & Dickens Ave",41.9199,-87.6488,829,804,0,0,829,804,1633,1633,0
"207",226,"Racine Ave & Belmont Ave",41.9397,-87.6589,551,598,0,0,551,598,1149,1149,0
"208",227,"Southport Ave & Waveland Ave",41.9482,-87.6639,927,958,0,0,927,958,1885,1885,0
"209",228,"Damen Ave & Melrose Ave",41.9406,-87.6785,302,294,0,0,302,294,596,596,0
"210",229,"Southport Ave & Roscoe St",41.9437,-87.664,800,848,0,0,800,848,1648,1648,0
"211",230,"Lincoln Ave & Roscoe St",41.9433,-87.671,538,539,0,0,538,539,1077,1077,0
"212",231,"Sheridan Rd & Montrose Ave",41.9617,-87.6546,855,905,0,0,855,905,1760,1760,0
"213",232,"Pine Grove Ave & Waveland Ave",41.9499,-87.6461,814,810,0,0,814,810,1624,1624,0
"214",233,"Sangamon St & Washington Blvd",41.8832,-87.6511,327,341,0,0,327,341,668,668,0
"215",234,"Clark St & Montrose Ave",41.9616,-87.666,352,331,0,0,352,331,683,683,0
"216",236,"Sedgwick St & Schiller St",41.9076,-87.6386,273,266,0,0,273,266,539,539,0
"217",237,"MLK Jr Dr & 29th St",41.8421,-87.617,627,588,0,0,627,588,1215,1215,0
"218",238,"Wolcott (Ravenswood) Ave & Montrose Ave",41.9614,-87.6762,276,256,0,0,276,256,532,532,0
"219",239,"Western Ave & Leland Ave",41.9665,-87.6884,304,335,0,0,304,335,639,639,0
"220",240,"Sheridan Rd & Irving Park Rd",41.9542,-87.6544,695,705,0,0,695,705,1400,1400,0
"221",241,"Morgan St & Polk St",41.8717,-87.651,296,291,0,0,296,291,587,587,0
"222",242,"Damen Ave & Leland Ave",41.9671,-87.679,316,319,0,0,316,319,635,635,0
"223",243,"Lincoln Ave & Sunnyside Ave",41.963,-87.6848,326,341,0,0,326,341,667,667,0
"224",244,"Ravenswood Ave & Irving Park Rd",41.9547,-87.6739,277,281,0,0,277,281,558,558,0
"225",245,"Clarendon Ave & Junior Ter",41.961,-87.6496,520,544,0,0,520,544,1064,1064,0
"226",246,"Ashland Ave & Belle Plaine Ave",41.9561,-87.6688,199,202,0,0,199,202,401,401,0
"227",247,"Shore Dr & 55th St",41.7952,-87.5807,356,354,0,0,356,354,710,710,0
"228",248,"Woodlawn Ave & 55th St",41.7953,-87.5965,169,167,0,0,169,167,336,336,0
"229",249,"Montrose Harbor",41.964,-87.6382,12,7,0,0,12,7,19,19,0
"230",250,"Ashland Ave & Wellington Ave",41.9361,-87.6698,356,375,0,0,356,375,731,731,0
"231",251,"Clarendon Ave & Leland Ave",41.968,-87.65,398,400,0,0,398,400,798,798,0
"232",252,"Greenwood Ave & 47th St",41.8098,-87.5994,194,191,0,0,194,191,385,385,0
"233",253,"Winthrop Ave & Lawrence Ave",41.9688,-87.6577,320,296,0,0,320,296,616,616,0
"234",254,"Pine Grove Ave & Irving Park Rd",41.9544,-87.648,802,731,0,0,802,731,1533,1533,0
"235",255,"Indiana Ave & Roosevelt Rd",41.8679,-87.623,1558,1542,0,0,1558,1542,3100,3100,0
"236",256,"Broadway & Sheridan Rd",41.9528,-87.65,747,644,0,0,747,644,1391,1391,0
"237",257,"Lincoln Ave & Waveland Ave",41.9488,-87.6753,387,405,0,0,387,405,792,792,0
"238",258,"Logan Blvd & Elston Ave",41.9295,-87.6842,415,462,0,0,415,462,877,877,0
"239",259,"California Ave & Francis Pl (Temp)",41.9185,-87.6974,224,231,0,0,224,231,455,455,0
"240",260,"Kedzie Ave & Milwaukee Ave",41.9296,-87.7079,720,790,0,0,720,790,1510,1510,0
"241",261,"Hermitage Ave & Polk St",41.8715,-87.6699,220,173,0,0,220,173,393,393,0
"242",262,"Halsted St & 37th St",41.8271,-87.6457,40,37,0,0,40,37,77,77,0
"243",263,"Rhodes Ave & 32nd St",41.8362,-87.6135,260,262,0,0,260,262,522,522,0
"244",264,"Stetson Ave & South Water St",41.8868,-87.6223,542,482,0,0,542,482,1024,1024,0
"245",265,"Cottage Grove Ave & Oakwood Blvd",41.823,-87.6071,141,138,0,0,141,138,279,279,0
"246",267,"Lake Park Ave & 47th St",41.8094,-87.5919,92,102,0,0,92,102,194,194,0
"247",268,"Lake Shore Dr & North Blvd",41.9117,-87.6268,1069,1045,0,0,1069,1045,2114,2114,0
"248",270,"Stony Island Ave & 75th St",41.7587,-87.5869,28,29,0,0,28,29,57,57,0
"249",271,"Cottage Grove Ave & 43rd St",41.8165,-87.6066,99,99,0,0,99,99,198,198,0
"250",272,"Indiana Ave & 31st St",41.8388,-87.6219,206,211,0,0,206,211,417,417,0
"251",273,"Michigan Ave & 18th St",41.8578,-87.6246,642,634,0,0,642,634,1276,1276,0
"252",274,"Racine Ave & 15th St",41.8613,-87.6566,121,126,0,0,121,126,247,247,0
"253",275,"Ashland Ave & 13th St",41.8652,-87.6665,120,134,0,0,120,134,254,254,0
"254",276,"California Ave & North Ave",41.9104,-87.6972,382,418,0,0,382,418,800,800,0
"255",277,"Ashland Ave & Grand Ave",41.8911,-87.6666,271,300,0,0,271,300,571,571,0
"256",278,"Wallace St & 35th St",41.8306,-87.6413,100,119,0,0,100,119,219,219,0
"257",279,"Halsted St & 35th St",41.8307,-87.6472,109,108,0,0,109,108,217,217,0
"258",280,"Morgan St & 31st St",41.8378,-87.6511,110,125,0,0,110,125,235,235,0
"259",281,"Western Ave & 24th St",41.8485,-87.6851,76,77,0,0,76,77,153,153,0
"260",282,"Halsted St & Maxwell St",41.8649,-87.6471,361,351,0,0,361,351,712,712,0
"261",283,"LaSalle St & Jackson Blvd",41.8782,-87.6319,329,312,0,0,329,312,641,641,0
"262",284,"Michigan Ave & Jackson Blvd",41.8779,-87.6241,353,362,0,0,353,362,715,715,0
"263",285,"Wood St & Hubbard St",41.8899,-87.6715,181,179,0,0,181,179,360,360,0
"264",286,"Franklin St & Adams St (Temp)",41.8794,-87.6355,154,124,0,0,154,124,278,278,0
"265",287,"Franklin St & Monroe St",41.8803,-87.6352,566,522,0,0,566,522,1088,1088,0
"266",288,"Larrabee St & Armitage Ave",41.9181,-87.6437,601,550,0,0,601,550,1151,1151,0
"267",289,"Wells St & Concord Ln",41.9121,-87.6347,1298,1326,0,0,1298,1326,2624,2624,0
"268",290,"Kedzie Ave & Palmer Ct",41.9215,-87.7073,342,369,0,0,342,369,711,711,0
"269",291,"Wells St & Evergreen Ave",41.9067,-87.6348,1247,1266,0,0,1247,1266,2513,2513,0
"270",292,"Southport Ave & Clark St",41.9571,-87.6642,259,256,0,0,259,256,515,515,0
"271",293,"Broadway & Wilson Ave",41.9652,-87.6581,523,553,0,0,523,553,1076,1076,0
"272",294,"Broadway & Berwyn Ave",41.9784,-87.6598,514,562,0,0,514,562,1076,1076,0
"273",295,"Broadway & Argyle St",41.9738,-87.6597,406,388,0,0,406,388,794,794,0
"274",296,"Broadway & Belmont Ave",41.9401,-87.6455,707,706,0,0,707,706,1413,1413,0
"275",297,"Paulina St & Montrose Ave",41.9615,-87.6714,213,203,0,0,213,203,416,416,0
"276",298,"Lincoln Ave & Belle Plaine Ave",41.956,-87.6803,335,321,0,0,335,321,656,656,0
"277",299,"Halsted St & Roscoe St",41.9437,-87.649,1130,1112,0,0,1130,1112,2242,2242,0
"278",300,"Broadway & Barry Ave",41.9377,-87.6441,1369,1486,0,0,1369,1486,2855,2855,0
"279",301,"Clark St & Schiller St",41.908,-87.6315,1379,1127,0,0,1379,1127,2506,2506,0
"280",302,"Sheffield Ave & Wrightwood Ave",41.9287,-87.6538,794,811,0,0,794,811,1605,1605,0
"281",303,"Broadway & Cornelia Ave",41.9455,-87.6464,1136,1180,0,0,1136,1180,2316,2316,0
"282",304,"Broadway & Waveland Ave",41.9491,-87.6486,881,944,0,0,881,944,1825,1825,0
"283",305,"Western Ave & Division St",41.9029,-87.6873,301,233,0,0,301,233,534,534,0
"284",306,"Sheridan Rd & Buena Ave",41.9585,-87.655,466,378,0,0,466,378,844,844,0
"285",307,"Southport Ave & Clybourn Ave",41.9208,-87.6637,277,279,0,0,277,279,556,556,0
"286",308,"Seeley Ave & Roscoe St",41.9434,-87.6796,290,305,0,0,290,305,595,595,0
"287",309,"Leavitt St & Armitage Ave",41.9178,-87.6824,341,354,0,0,341,354,695,695,0
"288",310,"Damen Ave & Charleston St",41.9201,-87.6779,315,296,0,0,315,296,611,611,0
"289",311,"Leavitt St & Lawrence Ave",41.9689,-87.684,161,189,0,0,161,189,350,350,0
"290",312,"Clarendon Ave & Gordon Ter",41.9579,-87.6495,626,577,0,0,626,577,1203,1203,0
"291",313,"Lakeview Ave & Fullerton Pkwy",41.9259,-87.639,1136,1110,0,0,1136,1110,2246,2246,0
"292",314,"Ravenswood Ave & Berteau Ave",41.9579,-87.6736,170,169,0,0,170,169,339,339,0
"293",315,"Elston Ave & Wabansia Ave",41.9129,-87.6642,195,236,0,0,195,236,431,431,0
"294",316,"Damen Ave & Sunnyside Ave",41.9633,-87.6793,234,217,0,0,234,217,451,451,0
"295",317,"Wood St & Taylor St",41.8692,-87.671,377,300,0,0,377,300,677,677,0
"296",318,"Southport Ave & Irving Park Rd",41.9542,-87.6644,444,394,0,0,444,394,838,838,0
"297",319,"Greenview Ave & Diversey Pkwy",41.9326,-87.6659,271,251,0,0,271,251,522,522,0
"298",320,"Loomis St & Lexington St",41.8722,-87.6615,801,797,0,0,801,797,1598,1598,0
"299",321,"Wabash Ave & 9th St",41.8708,-87.6257,957,938,0,0,957,938,1895,1895,0
"300",322,"Kimbark Ave & 53rd St",41.7996,-87.5947,457,477,0,0,457,477,934,934,0
"301",323,"Sheridan Rd & Lawrence Ave",41.9695,-87.6547,282,270,0,0,282,270,552,552,0
"302",324,"Stockton Dr & Wrightwood Ave",41.9313,-87.6387,1443,1418,0,0,1443,1418,2861,2861,0
"303",325,"Clark St & Winnemac Ave",41.9733,-87.6678,617,640,0,0,617,640,1257,1257,0
"304",326,"Clark St & Leland Ave",41.9671,-87.6674,532,492,0,0,532,492,1024,1024,0
"305",327,"Sheffield Ave & Webster Ave",41.9215,-87.6538,647,628,0,0,647,628,1275,1275,0
"306",328,"Ellis Ave & 58th St",41.7887,-87.6013,151,144,0,0,151,144,295,295,0
"307",329,"Lake Shore Dr & Diversey Pkwy",41.9326,-87.6364,923,852,0,0,923,852,1775,1775,0
"308",330,"Lincoln Ave & Addison St",41.9462,-87.6733,248,253,0,0,248,253,501,501,0
"309",331,"Halsted St & Clybourn Ave",41.9097,-87.6481,756,757,0,0,756,757,1513,1513,0
"310",332,"Burling St (Halsted) & Diversey Pkwy (Temp)",41.9331,-87.6478,585,686,0,0,585,686,1271,1271,0
"311",333,"Ashland Ave & Blackhawk St",41.9071,-87.6673,572,592,0,0,572,592,1164,1164,0
"312",334,"Lake Shore Dr & Belmont Ave",41.9408,-87.6392,817,828,0,0,817,828,1645,1645,0
"313",335,"Calumet Ave & 35th St",41.8314,-87.618,90,86,0,0,90,86,176,176,0
"314",336,"Cottage Grove Ave & 47th St",41.8099,-87.6068,172,187,0,0,172,187,359,359,0
"315",337,"Clark St & Chicago Ave",41.8968,-87.6309,893,805,0,0,893,805,1698,1698,0
"316",338,"Calumet Ave & 18th St",41.8576,-87.6194,389,409,0,0,389,409,798,798,0
"317",339,"Emerald Ave & 31st St",41.8382,-87.6451,233,237,0,0,233,237,470,470,0
"318",340,"Clark St & Wrightwood Ave",41.9295,-87.6431,1092,1091,0,0,1092,1091,2183,2183,0
"319",341,"Adler Planetarium",41.8661,-87.6073,43,43,0,0,43,43,86,86,0
"320",342,"Wolcott Ave & Polk St",41.8713,-87.6737,435,357,0,0,435,357,792,792,0
"321",343,"Racine Ave & Wrightwood Ave",41.9289,-87.659,318,324,0,0,318,324,642,642,0
"322",344,"Ravenswood Ave & Lawrence Ave",41.9691,-87.6742,527,520,0,0,527,520,1047,1047,0
"323",345,"Lake Park Ave & 56th St",41.7932,-87.5878,266,256,0,0,266,256,522,522,0
"324",346,"Ada St & Washington Blvd",41.8828,-87.6612,441,396,0,0,441,396,837,837,0
"325",347,"Ashland Ave & Grace St",41.9507,-87.6687,409,386,0,0,409,386,795,795,0
"326",348,"California Ave & 21st St",41.8538,-87.6957,83,89,0,0,83,89,172,172,0
"327",349,"Halsted St & Wrightwood Ave",41.9291,-87.6491,787,795,0,0,787,795,1582,1582,0
"328",350,"Ashland Ave & Chicago Ave",41.896,-87.6677,435,410,0,0,435,410,845,845,0
"329",351,"Cottage Grove Ave & 51st St",41.803,-87.6066,171,174,0,0,171,174,345,345,0
"330",352,"Jeffery Blvd & 67th St",41.7735,-87.5771,58,57,0,0,58,57,115,115,0
"331",353,"Clark St & Touhy Ave",42.0126,-87.6744,72,78,0,0,72,78,150,150,0
"332",354,"Sheridan Rd & Greenleaf Ave",42.0106,-87.6624,289,268,0,0,289,268,557,557,0
"333",355,"South Shore Dr & 67th St",41.7736,-87.5675,136,125,0,0,136,125,261,261,0
"334",356,"Stony Island Ave & 71st St",41.7665,-87.5865,40,39,0,0,40,39,79,79,0
"335",359,"Larrabee St & Division St",41.9035,-87.6434,786,809,0,0,786,809,1595,1595,0
"336",364,"Larrabee St & Oak St",41.9002,-87.643,312,298,0,0,312,298,610,610,0
"337",365,"Halsted St & North Branch St",41.8994,-87.6485,129,116,0,0,129,116,245,245,0
"338",366,"Loomis St & Archer Ave",41.8416,-87.6574,76,79,0,0,76,79,155,155,0
"339",367,"Racine Ave & 35th St",41.8307,-87.656,57,50,0,0,57,50,107,107,0
"340",368,"Ashland Ave & Archer Ave",41.8392,-87.6656,45,47,0,0,45,47,92,92,0
"341",369,"Wood St & 35th St",41.8301,-87.6703,112,108,0,0,112,108,220,220,0
"342",370,"Calumet Ave & 21st St",41.8542,-87.6192,164,189,0,0,164,189,353,353,0
"343",373,"Kedzie Ave & Chicago Ave",41.8955,-87.7061,59,70,0,0,59,70,129,129,0
"344",374,"Western Ave & Walton St",41.8984,-87.6866,438,441,0,0,438,441,879,879,0
"345",375,"Sacramento Blvd & Franklin Blvd",41.8905,-87.7026,62,60,0,0,62,60,122,122,0
"346",376,"Artesian Ave & Hubbard St",41.8895,-87.6882,144,92,0,0,144,92,236,236,0
"347",377,"Kedzie Ave & Lake St",41.8846,-87.7063,94,101,0,0,94,101,195,195,0
"348",378,"California Ave & Lake St",41.8845,-87.6963,62,73,0,0,62,73,135,135,0
"349",381,"Western Ave & Monroe St",41.8798,-87.6861,191,195,0,0,191,195,386,386,0
"350",382,"Western Ave & Congress Pkwy",41.8747,-87.6864,218,227,0,0,218,227,445,445,0
"351",383,"Paulina St & Flournoy St",41.873,-87.6691,266,241,0,0,266,241,507,507,0
"352",384,"Halsted St & 51st St",41.8018,-87.6452,10,10,0,0,10,10,20,20,0
"353",385,"Princeton Ave & Garfield Blvd",41.795,-87.6331,18,18,0,0,18,18,36,36,0
"354",386,"Halsted St & 56th St",41.7929,-87.645,8,11,0,0,8,11,19,19,0
"355",388,"Halsted St & 63rd St",41.7794,-87.6446,22,19,0,0,22,19,41,41,0
"356",390,"Wentworth Ave & 63rd St",41.7801,-87.6297,15,12,0,0,15,12,27,27,0
"357",391,"Halsted St & 69th St",41.7691,-87.6446,7,5,0,0,7,5,12,12,0
"358",392,"Perry Ave & 69th St",41.7693,-87.6282,10,8,0,0,10,8,18,18,0
"359",393,"Calumet Ave & 71st St",41.7655,-87.6169,10,7,0,0,10,7,17,17,0
"360",394,"Clark St & 9th St (AMLI)",41.8708,-87.6312,273,279,0,0,273,279,552,552,0
"361",395,"Jeffery Blvd & 76th St",41.7571,-87.5758,12,13,0,0,12,13,25,25,0
"362",396,"Yates Blvd & 75th St",41.7588,-87.5664,13,18,0,0,13,18,31,31,0
"363",398,"Rainbow Beach",41.7579,-87.5494,13,13,0,0,13,13,26,26,0
"364",399,"South Shore Dr & 74th St",41.7622,-87.5593,55,55,0,0,55,55,110,110,0
"365",400,"Cottage Grove Ave & 71st St",41.7657,-87.605,4,8,0,0,4,8,12,12,0
"366",401,"Shields Ave & 28th Pl",41.8427,-87.6355,35,33,0,0,35,33,68,68,0
"367",402,"Shields Ave & 31st St",41.8385,-87.6354,90,95,0,0,90,95,185,185,0
"368",403,"Wentworth Ave & 33rd St",41.8345,-87.6318,38,44,0,0,38,44,82,82,0
"369",405,"Wentworth Ave & 35th St",41.8308,-87.6325,55,49,0,0,55,49,104,104,0
"370",406,"Lake Park Ave & 35th St",41.8313,-87.6088,233,228,0,0,233,228,461,461,0
"371",407,"State St & Pershing Rd",41.823,-87.6266,57,46,0,0,57,46,103,103,0
"372",408,"Union Ave & Root St",41.8191,-87.6433,31,31,0,0,31,31,62,62,0
"373",409,"Shields Ave & 43rd St",41.8162,-87.6348,4,2,0,0,4,2,6,6,0
"374",410,"Prairie Ave & 43rd St",41.8167,-87.6194,123,128,0,0,123,128,251,251,0
"375",411,"Halsted St & 47th Pl",41.8081,-87.6456,34,33,0,0,34,33,67,67,0
"376",412,"Princeton Ave & 47th St",41.8093,-87.6334,36,32,0,0,36,32,68,68,0
"377",413,"Woodlawn Ave & Lake Park Ave",41.8141,-87.597,133,125,0,0,133,125,258,258,0
"378",414,"Canal St & Taylor St",41.8703,-87.6395,204,212,0,0,204,212,416,416,0
"379",415,"Calumet Ave & 51st St",41.8023,-87.6181,94,97,0,0,94,97,191,191,0
"380",416,"Dorchester Ave & 49th St",41.8058,-87.5925,91,87,0,0,91,87,178,178,0
"381",417,"Cornell Ave & Hyde Park Blvd",41.8024,-87.5869,351,363,0,0,351,363,714,714,0
"382",418,"Ellis Ave & 53rd St",41.7993,-87.601,270,263,0,0,270,263,533,533,0
"383",419,"Lake Park Ave & 53rd St",41.7995,-87.5865,205,226,0,0,205,226,431,431,0
"384",420,"Ellis Ave & 55th St",41.7943,-87.6014,155,141,0,0,155,141,296,296,0
"385",421,"MLK Jr Dr & 56th St",41.7934,-87.6159,61,54,0,0,61,54,115,115,0
"386",422,"DuSable Museum",41.7916,-87.6079,126,124,0,0,126,124,250,250,0
"387",423,"University Ave & 57th St",41.7915,-87.5999,265,273,0,0,265,273,538,538,0
"388",424,"Museum of Science and Industry",41.7917,-87.5839,192,184,0,0,192,184,376,376,0
"389",425,"Harper Ave & 59th St",41.7879,-87.5883,140,136,0,0,140,136,276,276,0
"390",426,"Ellis Ave & 60th St",41.7851,-87.6011,248,241,0,0,248,241,489,489,0
"391",427,"Cottage Grove Ave & 63rd St",41.7806,-87.6061,47,46,0,0,47,46,93,93,0
"392",428,"Dorchester Ave & 63rd St",41.7804,-87.5914,94,103,0,0,94,103,197,197,0
"393",429,"Cottage Grove Ave & 67th St",41.7737,-87.6056,20,18,0,0,20,18,38,38,0
"394",430,"MLK Jr Dr & 63rd St",41.7801,-87.6159,30,31,0,0,30,31,61,61,0
"395",431,"Eberhart Ave & 61st St",41.7841,-87.6133,47,40,0,0,47,40,87,87,0
"396",432,"Clark St & Lunt Ave",42.0091,-87.6742,142,134,0,0,142,134,276,276,0
"397",433,"Kedzie Ave & Harrison St",41.8736,-87.7049,10,18,0,0,10,18,28,28,0
"398",434,"Ogden Ave & Roosevelt Rd",41.8665,-87.6847,172,154,0,0,172,154,326,326,0
"399",435,"Kedzie Ave & Roosevelt Rd",41.8665,-87.7065,14,14,0,0,14,14,28,28,0
"400",436,"Fairfield Ave & Roosevelt Rd",41.8666,-87.6945,38,41,0,0,38,41,79,79,0
"401",437,"Washtenaw Ave & Ogden Ave",41.8619,-87.6935,37,49,0,0,37,49,86,86,0
"402",438,"Central Park Ave & Ogden Ave",41.8542,-87.7154,26,29,0,0,26,29,55,55,0
"403",439,"Kedzie Ave & 21st St",41.8535,-87.7051,21,19,0,0,21,19,40,40,0
"404",440,"Central Park Ave & 24th St",41.8481,-87.7151,15,17,0,0,15,17,32,32,0
"405",441,"Kedzie Ave & 24th St",41.8482,-87.7054,39,40,0,0,39,40,79,79,0
"406",442,"California Ave & 23rd Pl",41.8491,-87.6951,90,85,0,0,90,85,175,175,0
"407",443,"Millard Ave & 26th St",41.8446,-87.7159,24,29,0,0,24,29,53,53,0
"408",444,"Albany Ave & 26th St",41.8445,-87.702,29,31,0,0,29,31,60,60,0
"409",445,"California Ave & 26th St",41.844,-87.6953,11,11,0,0,11,11,22,22,0
"410",446,"Western Ave & 28th St",41.8415,-87.6851,35,32,0,0,35,32,67,67,0
"411",447,"Glenwood Ave & Morse Ave",42.008,-87.6655,388,415,0,0,388,415,803,803,0
"412",448,"Warren Park East",42.0045,-87.6807,159,174,0,0,159,174,333,333,0
"413",449,"Clark St & Columbia Ave",42.0045,-87.6724,100,87,0,0,100,87,187,187,0
"414",450,"Warren Park West",42.0018,-87.6888,146,156,0,0,146,156,302,302,0
"415",451,"Sheridan Rd & Loyola Ave",42.001,-87.6612,405,461,0,0,405,461,866,866,0
"416",452,"Western Ave & Granville Ave",41.9942,-87.6894,138,136,0,0,138,136,274,274,0
"417",453,"Clark St & Schreiber Ave",41.9993,-87.6714,186,196,0,0,186,196,382,382,0
"418",454,"Broadway & Granville Ave",41.9948,-87.6603,599,589,0,0,599,589,1188,1188,0
"419",455,"Maplewood Ave & Peterson Ave",41.9902,-87.6934,60,58,0,0,60,58,118,118,0
"420",456,"2112 W Peterson Ave",41.9912,-87.6836,89,88,0,0,89,88,177,177,0
"421",457,"Clark St & Elmdale Ave",41.9905,-87.6698,227,224,0,0,227,224,451,451,0
"422",458,"Broadway & Thorndale Ave",41.9897,-87.6601,374,413,0,0,374,413,787,787,0
"423",459,"Lakefront Trail & Bryn Mawr Ave",41.984,-87.6523,174,205,0,0,174,205,379,379,0
"424",460,"Clark St & Bryn Mawr Ave",41.9836,-87.6692,449,469,0,0,449,469,918,918,0
"425",461,"Broadway & Ridge Ave",41.984,-87.6603,548,532,0,0,548,532,1080,1080,0
"426",462,"Winchester (Ravenswood) Ave & Balmoral Ave",41.9798,-87.6775,123,119,0,0,123,119,242,242,0
"427",463,"Clark St & Berwyn Ave",41.978,-87.668,603,612,0,0,603,612,1215,1215,0
"428",464,"Damen Ave & Foster Ave",41.9756,-87.6795,337,306,0,0,337,306,643,643,0
"429",465,"Marine Dr & Ainslie St",41.9716,-87.6502,661,678,0,0,661,678,1339,1339,0
"430",466,"Ridge Blvd & Touhy Ave",42.0121,-87.6829,58,52,0,0,58,52,110,110,0
"431",467,"Western Ave & Lunt Ave",42.0086,-87.6905,178,160,0,0,178,160,338,338,0
"432",468,"Budlong Woods Library",41.9837,-87.6964,117,121,0,0,117,121,238,238,0
"433",469,"St. Louis Ave & Balmoral Ave",41.9804,-87.7161,134,137,0,0,134,137,271,271,0
"434",470,"Kedzie Ave & Foster Ave",41.9757,-87.7093,92,103,0,0,92,103,195,195,0
"435",471,"Francisco Ave & Foster Ave",41.9756,-87.7014,267,252,0,0,267,252,519,519,0
"436",472,"Lincoln Ave & Winona St",41.9749,-87.6925,206,214,0,0,206,214,420,420,0
"437",474,"Christiana Ave & Lawrence Ave",41.9684,-87.7118,104,104,0,0,104,104,208,208,0
"438",475,"Washtenaw Ave & Lawrence Ave",41.969,-87.696,251,253,0,0,251,253,504,504,0
"439",476,"Kedzie Ave & Leland Ave",41.9667,-87.7081,148,132,0,0,148,132,280,280,0
"440",477,"Manor Ave & Leland Ave",41.9659,-87.7008,208,195,0,0,208,195,403,403,0
"441",478,"Rockwell St & Eastwood Ave",41.9659,-87.6936,208,177,0,0,208,177,385,385,0
"442",479,"Drake Ave & Montrose Ave",41.9612,-87.7166,85,94,0,0,85,94,179,179,0
"443",480,"Albany Ave & Montrose Ave",41.961,-87.7059,158,157,0,0,158,157,315,315,0
"444",481,"California Ave & Montrose Ave",41.9611,-87.6954,495,500,0,0,495,500,995,995,0
"445",482,"Campbell Ave & Montrose Ave",41.9615,-87.6912,199,198,0,0,199,198,397,397,0
"446",483,"Avondale Ave & Irving Park Rd",41.9534,-87.732,79,76,0,0,79,76,155,155,0
"447",484,"Monticello Ave & Irving Park Rd",41.954,-87.7191,113,108,0,0,113,108,221,221,0
"448",485,"Sawyer Ave & Irving Park Rd",41.9536,-87.7093,131,126,0,0,131,126,257,257,0
"449",486,"Oakley Ave & Irving Park Rd",41.9543,-87.6861,176,165,0,0,176,165,341,341,0
"450",487,"California Ave & Byron St",41.9522,-87.6981,316,314,0,0,316,314,630,630,0
"451",488,"Pulaski Rd & Eddy St (Temp)",41.9463,-87.731,79,77,0,0,79,77,156,156,0
"452",489,"Drake Ave & Addison St",41.9473,-87.7176,61,58,0,0,61,58,119,119,0
"453",490,"Troy St & Elston Ave",41.9452,-87.7066,225,229,0,0,225,229,454,454,0
"454",491,"Talman Ave & Addison St",41.9466,-87.6946,251,245,0,0,251,245,496,496,0
"455",492,"Leavitt St & Addison St",41.9467,-87.6834,131,125,0,0,131,125,256,256,0
"456",493,"Western Ave & Roscoe St",41.943,-87.6873,257,270,0,0,257,270,527,527,0
"457",494,"Kedzie Ave & Bryn Mawr Ave",41.9824,-87.7089,159,175,0,0,159,175,334,334,0
"458",495,"Keystone Ave & Montrose Ave",41.9611,-87.729,97,102,0,0,97,102,199,199,0
"459",496,"Avers Ave & Belmont Ave",41.9394,-87.7236,176,182,0,0,176,182,358,358,0
"460",497,"Kimball Ave & Belmont Ave",41.9394,-87.7116,151,156,0,0,151,156,307,307,0
"461",498,"California Ave & Fletcher St",41.9384,-87.698,173,185,0,0,173,185,358,358,0
"462",499,"Kosciuszko Park",41.9306,-87.7238,208,218,0,0,208,218,426,426,0
"463",500,"Central Park Ave & Elbridge Ave",41.9353,-87.7169,155,155,0,0,155,155,310,310,0
"464",501,"Richmond St & Diversey Ave",41.9319,-87.7012,192,203,0,0,192,203,395,395,0
"465",502,"California Ave & Altgeld St",41.9267,-87.6977,247,271,0,0,247,271,518,518,0
"466",503,"Drake Ave & Fullerton Ave",41.9244,-87.7154,188,208,0,0,188,208,396,396,0
"467",504,"Campbell Ave & Fullerton Ave",41.9246,-87.6893,234,215,0,0,234,215,449,449,0
"468",505,"Winchester Ave & Elston Ave",41.9241,-87.6765,187,194,0,0,187,194,381,381,0
"469",506,"Spaulding Ave & Armitage Ave",41.9171,-87.7102,192,175,0,0,192,175,367,367,0
"470",507,"Humboldt Blvd & Armitage Ave",41.9175,-87.7018,293,291,0,0,293,291,584,584,0
"471",508,"Central Park Ave & North Ave",41.9097,-87.7166,87,85,0,0,87,85,172,172,0
"472",509,"Troy St & North Ave",41.9098,-87.7053,496,511,0,0,496,511,1007,1007,0
"473",510,"Spaulding Ave & Division St",41.9027,-87.7092,182,176,0,0,182,176,358,358,0
"474",511,"Albany Ave & Bloomingdale Ave",41.914,-87.7051,141,136,0,0,141,136,277,277,0
"475",514,"Ridge Blvd & Howard St",42.0193,-87.6845,64,55,0,0,64,55,119,119,0
"476",515,"Paulina St & Howard St",42.0192,-87.6736,95,109,0,0,95,109,204,204,0
"477",517,"Clark St & Jarvis Ave",42.016,-87.675,110,108,0,0,110,108,218,218,0
"478",518,"Conservatory Dr & Lake St",41.8855,-87.7169,83,83,0,0,83,83,166,166,0
"479",519,"Wolcott Ave & Fargo Ave",42.017,-87.6777,41,38,0,0,41,38,79,79,0
"480",520,"Greenview Ave & Jarvis Ave",42.016,-87.6686,209,193,0,0,209,193,402,402,0
"481",522,"Bosworth Ave & Howard St",42.0195,-87.6696,41,38,0,0,41,38,79,79,0
"482",523,"Eastlake Ter & Rogers Ave",42.0209,-87.6651,227,220,0,0,227,220,447,447,0
"483",524,"Austin Blvd & Chicago Ave",41.8949,-87.7747,37,41,0,0,37,41,78,78,0
"484",525,"Glenwood Ave & Touhy Ave",42.0127,-87.6661,108,99,0,0,108,99,207,207,0
"485",526,"Oakley Ave & Touhy Ave",42.0123,-87.6882,41,32,0,0,41,32,73,73,0
"486",527,"Western Ave & Howard St",42.0189,-87.69,56,54,0,0,56,54,110,110,0
"487",528,"Pulaski Rd & Lake St",41.8854,-87.7265,8,8,0,0,8,8,16,16,0
"488",529,"Cicero Ave & Lake St",41.8868,-87.7453,13,9,0,0,13,9,22,22,0
"489",530,"Laramie Ave & Kinzie St",41.8878,-87.7555,10,8,0,0,10,8,18,18,0
"490",531,"Central Ave & Lake St",41.8877,-87.7655,17,15,0,0,17,15,32,32,0
"491",532,"Austin Blvd & Lake St",41.8879,-87.7744,68,62,0,0,68,62,130,130,0
"492",533,"Central Park Blvd & 5th Ave",41.8757,-87.7155,12,19,0,0,12,19,31,31,0
"493",534,"Karlov Ave & Madison St",41.8809,-87.7279,18,19,0,0,18,19,37,37,0
"494",535,"Pulaski Rd & Congress Pkwy",41.8743,-87.7257,17,18,0,0,17,18,35,35,0
"495",536,"Kostner Ave & Lake St",41.8859,-87.7354,3,4,0,0,3,4,7,7,0
"496",537,"Kenton Ave & Madison St",41.8807,-87.741,5,5,0,0,5,5,10,10,0
"497",538,"Cicero Ave & Flournoy St",41.8721,-87.7466,4,8,0,0,4,8,12,12,0
"498",539,"Cicero Ave & Quincy St",41.8776,-87.7454,16,19,0,0,16,19,35,35,0
"499",540,"Laramie Ave & Madison St",41.8802,-87.7553,31,21,0,0,31,21,52,52,0
"500",541,"Central Ave & Harrison St",41.873,-87.7645,11,13,0,0,11,13,24,24,0
"501",542,"Central Ave & Madison St",41.8801,-87.7632,24,21,0,0,24,21,45,45,0
"502",543,"Laramie Ave & Gladys Ave",41.8758,-87.7553,4,4,0,0,4,4,8,8,0
"503",544,"Austin Blvd & Madison St",41.8803,-87.7745,72,73,0,0,72,73,145,145,0
"504",545,"Kostner Ave & Adams St",41.8779,-87.7357,15,15,0,0,15,15,30,30,0
"505",546,"Damen Ave & Pershing Rd",41.8232,-87.6766,91,91,0,0,91,91,182,182,0
"506",547,"Ashland Ave & Pershing Rd",41.8235,-87.6656,25,26,0,0,25,26,51,51,0
"507",548,"Morgan St & Pershing Rd",41.8236,-87.6509,19,15,0,0,19,15,34,34,0
"508",549,"Marshfield Ave & 44th St",41.814,-87.6666,10,12,0,0,10,12,22,22,0
"509",550,"Central Ave & Chicago Ave",41.895,-87.7649,35,35,0,0,35,35,70,70,0
"510",551,"Hoyne Ave & 47th St",41.8082,-87.6772,17,14,0,0,17,14,31,31,0
"511",552,"Ashland Ave & McDowell Ave",41.8089,-87.6645,19,18,0,0,19,18,37,37,0
"512",553,"Elizabeth St & 47th St",41.8084,-87.6565,5,7,0,0,5,7,12,12,0
"513",554,"Damen Ave & 51st St",41.8009,-87.6747,8,7,0,0,8,7,15,15,0
"514",555,"Ashland Ave & 50th St",41.803,-87.6647,21,16,0,0,21,16,37,37,0
"515",556,"Throop St & 52nd St",41.7997,-87.6572,1,3,0,0,1,3,4,4,0
"516",557,"Seeley Ave & Garfield Blvd",41.7941,-87.6755,18,21,0,0,18,21,39,39,0
"517",558,"Ashland Ave & Garfield Blvd",41.7928,-87.6644,13,16,0,0,13,16,29,29,0
"518",559,"Racine Ave & Garfield Blvd",41.7942,-87.6551,12,18,0,0,12,18,30,30,0
"519",560,"Marshfield Ave & 59th St",41.7868,-87.6662,8,7,0,0,8,7,15,15,0
"520",561,"Damen Ave & 59th St",41.786,-87.6742,2,3,0,0,2,3,5,5,0
"521",562,"Racine Ave & 61st St",41.7832,-87.6544,1,1,0,0,1,1,2,2,0
"522",563,"Ashland Ave & 63rd St",41.7794,-87.6648,7,7,0,0,7,7,14,14,0
"523",564,"Racine Ave & 65th St",41.7754,-87.6543,6,4,0,0,6,4,10,10,0
"524",565,"Ashland Ave & 66th St",41.7741,-87.6638,3,2,0,0,3,2,5,5,0
"525",566,"Ashland Ave & 69th St",41.7687,-87.6641,6,7,0,0,6,7,13,13,0
"526",567,"May St & 69th St",41.7689,-87.6529,9,11,0,0,9,11,20,20,0
"527",568,"Vincennes Ave & 75th St",41.758,-87.6312,10,11,0,0,10,11,21,21,0
"528",569,"Woodlawn Ave & 75th St",41.7592,-87.5958,9,11,0,0,9,11,20,20,0
"529",570,"Evans Ave & 75th St",41.7585,-87.6064,4,2,0,0,4,2,6,6,0
"530",571,"Vernon Ave & 75th St",41.7584,-87.6141,13,16,0,0,13,16,29,29,0
"531",572,"State St & 76th St",41.757,-87.6246,12,7,0,0,12,7,19,19,0
"532",573,"State St & 79th St",41.7508,-87.6244,22,17,0,0,22,17,39,39,0
"533",574,"Vernon Ave & 79th St",41.7509,-87.6138,8,8,0,0,8,8,16,16,0
"534",575,"Cottage Grove Ave & 78th St",41.7532,-87.605,20,17,0,0,20,17,37,37,0
"535",576,"Greenwood Ave & 79th St",41.7513,-87.5976,3,4,0,0,3,4,7,7,0
"536",577,"Stony Island Ave & South Chicago Ave",41.7512,-87.5853,8,8,0,0,8,8,16,16,0
"537",578,"Bennett Ave & 79th St",41.7518,-87.5785,1,2,0,0,1,2,3,3,0
"538",579,"Phillips Ave & 79th St",41.7518,-87.5652,36,34,0,0,36,34,70,70,0
"539",580,"Exchange Ave & 79th St",41.7517,-87.5528,13,10,0,0,13,10,23,23,0
"540",581,"Commercial Ave & 83rd St",41.7446,-87.5512,28,31,0,0,28,31,59,59,0
"541",582,"Phillips Ave & 83rd St",41.7445,-87.5651,12,14,0,0,12,14,26,26,0
"542",583,"Stony Island Ave & 82nd St",41.7466,-87.586,8,8,0,0,8,8,16,16,0
"543",584,"Ellis Ave & 83rd St",41.7441,-87.599,11,9,0,0,11,9,20,20,0
"544",585,"Cottage Grove Ave & 83rd St",41.7434,-87.6048,20,22,0,0,20,22,42,42,0
"545",586,"MLK Jr Dr & 83rd St",41.7431,-87.6148,10,7,0,0,10,7,17,17,0
"546",587,"Wabash Ave & 83rd St",41.7433,-87.6228,23,20,0,0,23,20,43,43,0
"547",588,"South Chicago Ave & 83rd St",41.7439,-87.5752,9,14,0,0,9,14,23,23,0
"548",589,"Milwaukee Ave & Cuyler Ave",41.9545,-87.7496,77,86,0,0,77,86,163,163,0
"549",590,"Kilbourn Ave & Irving Park Rd",41.9537,-87.7406,37,32,0,0,37,32,69,69,0
"550",591,"Kilbourn Ave & Milwaukee Ave",41.9488,-87.74,67,67,0,0,67,67,134,134,0
"551",592,"Knox Ave & Montrose Ave",41.9606,-87.7454,49,48,0,0,49,48,97,97,0
"552",593,"Halsted St & 59th St",41.7875,-87.6449,11,7,0,0,11,7,18,18,0
"553",594,"Western Blvd & 48th Pl",41.8057,-87.6834,46,42,0,0,46,42,88,88,0
"554",595,"Wabash Ave & 87th St",41.7366,-87.6226,15,13,0,0,15,13,28,28,0
"555",596,"Benson Ave & Church St",42.0482,-87.6835,305,318,0,0,305,318,623,623,0
"556",597,"Chicago Ave & Washington St",42.0326,-87.6791,326,334,0,0,326,334,660,660,0
"557",598,"Elmwood Ave & Austin St",42.0258,-87.6841,86,85,0,0,86,85,171,171,0
"558",599,"Valli Produce - Evanston Plaza",42.0397,-87.6994,90,87,0,0,90,87,177,177,0
"559",600,"Dodge Ave & Church St",42.0483,-87.6982,132,134,0,0,132,134,266,266,0
"560",601,"Central St Metra",42.0636,-87.6987,127,132,0,0,127,132,259,259,0
"561",602,"Central St & Girard Ave",42.0643,-87.6862,173,178,0,0,173,178,351,351,0
"562",603,"Chicago Ave & Sheridan Rd",42.0505,-87.6778,237,267,0,0,237,267,504,504,0
"563",604,"Sheridan Rd & Noyes St (NU)",42.0582,-87.6774,270,259,0,0,270,259,529,529,0
"564",605,"University Library (NU)",42.0529,-87.6734,277,279,0,0,277,279,556,556,0
"565",619,"Keystone Ave & Fullerton Ave",41.9246,-87.7279,84,83,0,0,84,83,167,167,0
"566",620,"Orleans St & Chestnut St (NEXT Apts)",41.8982,-87.6375,525,490,0,0,525,490,1015,1015,0
"567",621,"Aberdeen St & Randolph St",41.8841,-87.6543,281,288,0,0,281,288,569,569,0
"568",622,"California Ave & Cortez St",41.9004,-87.6967,403,406,0,0,403,406,809,809,0
"569",623,"Michigan Ave & 8th St",41.8728,-87.624,823,790,0,0,823,790,1613,1613,0
"570",624,"Dearborn St & Van Buren St",41.8763,-87.6292,316,314,0,0,316,314,630,630,0
"571",625,"Chicago Ave & Dempster St",42.0417,-87.6807,205,223,0,0,205,223,428,428,0
"572",626,"Delano Ct & Roosevelt Rd",41.8675,-87.6322,396,350,0,0,396,350,746,746,0
"573",627,"LaSalle Dr & Huron St",41.8949,-87.6323,667,648,0,0,667,648,1315,1315,0
"574",628,"Walsh Park",41.9146,-87.668,166,154,0,0,166,154,320,320,0
"575",630,"Kildare Ave & Montrose Ave",41.9611,-87.7357,78,94,0,0,78,94,172,172,0
"576",631,"Malcolm X College",41.8776,-87.6739,46,36,0,0,46,36,82,82,0
"577",632,"Clark St & Newport St",41.9445,-87.6547,162,349,0,0,162,349,511,511,0
"578",635,"Fairbanks St & Superior St",41.8957,-87.6201,409,476,0,0,409,476,885,885,0
"579",636,"Orleans St & Hubbard St",41.89,-87.6366,341,347,0,0,341,347,688,688,0
"580",637,"Wood St & Chicago Ave (*)",41.8956,-87.6721,30,188,0,0,30,188,218,218,0
"581",638,"Clinton St & Jackson Blvd",41.8781,-87.6398,212,212,0,0,212,212,424,424,0
"582",639,"Lakefront Trail & Wilson Ave",41.9658,-87.6454,7,11,0,0,7,11,18,18,0
"583",640,"Bernard St & Elston Ave",41.9499,-87.7139,9,33,0,0,9,33,42,42,0
"584",641,"Central Park Ave & Bloomingdale Ave",41.9142,-87.7168,10,37,0,0,10,37,47,47,0
"585",642,"Latrobe Ave & Chicago Ave",41.8947,-87.7569,6,8,0,0,6,8,14,14,0
"586",643,"Smith Park (*)",41.892,-87.6894,15,82,0,0,15,82,97,97,0
"587",644,"Western Ave & Fillmore St (*)",41.8686,-87.6862,39,124,0,0,39,124,163,163,0
"588",645,"Archer (Damen) Ave & 37th St",41.8267,-87.6831,76,77,0,0,76,77,153,153,0
"589",646,"State St & 54th St",41.7966,-87.6259,5,24,0,0,5,24,29,29,0
"590",647,"Elizabeth St & 59th St",41.7867,-87.6559,2,2,0,0,2,2,4,4,0
"591",648,"Carpenter St & 63rd St",41.7799,-87.6509,0,0,0,0,0,0,0,0,0
"592",649,"Stewart Ave & 63rd St (*)",41.7798,-87.6348,0,0,0,0,0,0,0,0,0
"593",650,"Eggleston Ave & 69th St (*)",41.7689,-87.6359,0,0,0,0,0,0,0,0,0
"594",651,"Michigan Ave & 71st St",41.7653,-87.6217,8,11,0,0,8,11,19,19,0
"595",652,"Rhodes Ave & 71st St",41.766,-87.6117,11,8,0,0,11,8,19,19,0
"596",653,"Cornell Dr & Hayes Dr",41.7806,-87.5848,64,58,0,0,64,58,122,122,0
"597",654,"Racine Ave & Washington Blvd (*)",41.8831,-87.657,10,69,0,0,10,69,79,79,0
"598",655,"Hoyne Ave & Balmoral Ave",41.9799,-87.6819,11,57,0,0,11,57,68,68,0
"599",656,"Damen Ave & Walnut (Lake) St (*)",41.886,-87.677,8,54,0,0,8,54,62,62,0
"600",657,"Wood St & Augusta Blvd",41.8992,-87.6722,471,451,0,0,471,451,922,922,0
"601",658,"Leavitt St & Division St (*)",41.903,-87.6838,16,161,0,0,16,161,177,177,0
"602",659,"Leavitt St & Chicago Ave",41.8955,-87.682,289,286,0,0,289,286,575,575,0
"603",660,"Sheridan Rd & Columbia Ave",42.0046,-87.6614,215,211,0,0,215,211,426,426,0
"604",661,"Evanston Civic Center",42.057,-87.6866,62,69,0,0,62,69,131,131,0
"605",662,"Dodge Ave & Mulford St",42.0235,-87.6996,113,123,0,0,113,123,236,236,0
"606",663,"Lincolnwood Dr & Central St",42.0649,-87.7153,61,60,0,0,61,60,121,121,0
"607",664,"Leavitt St & Belmont Ave (*)",41.9394,-87.6833,21,106,0,0,21,106,127,127,0
"608",666,"Cherry Ave & Blackhawk St",41.9072,-87.6556,44,42,0,0,44,42,86,86,0
"609",671,"HUBBARD ST BIKE CHECKING (LBS-WH-TEST)",41.89,-87.6807,98,119,0,0,98,119,217,217,0
"610",672,"Franklin St & Illinois St",41.891,-87.6355,628,577,0,0,628,577,1205,1205,0
"611",673,"Lincoln Park Conservatory",41.9239,-87.6358,928,939,0,0,928,939,1867,1867,0
"612",0,"",0,0,0,0,0,0,0,0,0,0,0
