"","station_id","station_name","lat","long","start_n","end_n","e_start_n","e_end_n","c_start_n","c_end_n","total","classic","electric"
"1",2,"Buckingham Fountain",41.876511,-87.620548,1814,1835,0,0,1814,1835,3649,3649,0
"2",3,"Shedd Aquarium",41.867225,-87.615355,528,509,0,0,528,509,1037,1037,0
"3",4,"Burnham Harbor",41.856268,-87.613348,1104,1097,0,0,1104,1097,2201,2201,0
"4",5,"State St & Harrison St",41.874053,-87.627716,467,483,0,0,467,483,950,950,0
"5",6,"Dusable Harbor",41.886976,-87.612813,810,802,0,0,810,802,1612,1612,0
"6",7,"Field Blvd & South Water St",41.886349,-87.617516,964,975,0,0,964,975,1939,1939,0
"7",9,"Leavitt St & Archer Ave",41.828792,-87.680604,78,88,0,0,78,88,166,166,0
"8",11,"Jeffery Blvd & 71st St",41.766638,-87.57645,94,101,0,0,94,101,195,195,0
"9",12,"South Shore Dr & 71st St",41.766409,-87.565688,292,285,0,0,292,285,577,577,0
"10",13,"Wilton Ave & Diversey Pkwy",41.932418,-87.652705,1257,1182,0,0,1257,1182,2439,2439,0
"11",14,"Morgan St & 18th St",41.858086,-87.651073,376,380,0,0,376,380,756,756,0
"12",15,"Racine Ave & 18th St",41.858166,-87.656495,453,429,0,0,453,429,882,882,0
"13",16,"Paulina Ave & North Ave",41.910337,-87.670072,794,810,0,0,794,810,1604,1604,0
"14",17,"Honore St & Division St",41.903119,-87.673935,1054,1044,0,0,1054,1044,2098,2098,0
"15",18,"Wacker Dr & Washington St",41.883132,-87.637321,436,434,0,0,436,434,870,870,0
"16",19,"Throop (Loomis) St & Taylor St",41.868968,-87.659141,436,441,0,0,436,441,877,877,0
"17",20,"Sheffield Ave & Kingsbury St",41.910522,-87.653106,834,835,0,0,834,835,1669,1669,0
"18",21,"Aberdeen St & Jackson Blvd",41.877726,-87.654787,813,788,0,0,813,788,1601,1601,0
"19",22,"May St & Taylor St",41.869482,-87.655486,671,695,0,0,671,695,1366,1366,0
"20",23,"Orleans St & Elm St",41.902924,-87.637715,451,427,0,0,451,427,878,878,0
"21",24,"Fairbanks Ct & Grand Ave",41.891847,-87.62058,2218,2239,0,0,2218,2239,4457,4457,0
"22",25,"Michigan Ave & Pearson St",41.89766,-87.62351,1003,992,0,0,1003,992,1995,1995,0
"23",26,"McClurg Ct & Illinois St",41.890359,-87.617532,1956,1838,0,0,1956,1838,3794,3794,0
"24",27,"Larrabee St & North Ave",41.91021,-87.6435,477,445,0,0,477,445,922,922,0
"25",28,"Larrabee St & Menomonee St",41.91468,-87.64332,395,399,0,0,395,399,794,794,0
"26",29,"Noble St & Milwaukee Ave",41.90068,-87.6626,861,839,0,0,861,839,1700,1700,0
"27",30,"Ashland Ave & Augusta Blvd",41.899643,-87.6677,612,558,0,0,612,558,1170,1170,0
"28",31,"Franklin St & Chicago Ave",41.896746,-87.635667,874,877,0,0,874,877,1751,1751,0
"29",32,"Racine Ave & Congress Pkwy",41.87464,-87.65703,246,242,0,0,246,242,488,488,0
"30",33,"State St & Van Buren St",41.877181,-87.627844,450,451,0,0,450,451,901,901,0
"31",34,"Cannon Dr & Fullerton Ave",41.926755,-87.634428,1001,993,0,0,1001,993,1994,1994,0
"32",35,"Streeter Dr & Grand Ave",41.892278,-87.612043,4006,4070,0,0,4006,4070,8076,8076,0
"33",36,"Franklin St & Jackson Blvd",41.877707,-87.635321,898,873,0,0,898,873,1771,1771,0
"34",37,"Dearborn St & Adams St",41.879356,-87.629791,454,427,0,0,454,427,881,881,0
"35",38,"Clark St & Lake St",41.88602,-87.630876,999,988,0,0,999,988,1987,1987,0
"36",39,"Wabash Ave & Adams St",41.879472,-87.625688,628,626,0,0,628,626,1254,1254,0
"37",40,"LaSalle St & Adams St",41.879344,-87.631985,249,242,0,0,249,242,491,491,0
"38",41,"Federal St & Polk St",41.872077,-87.629543,1432,1417,0,0,1432,1417,2849,2849,0
"39",42,"Wabash Ave & Cermak Rd",41.852619,-87.626488,275,285,0,0,275,285,560,560,0
"40",43,"Michigan Ave & Washington St",41.883984,-87.624683,1472,1435,0,0,1472,1435,2907,2907,0
"41",44,"State St & Randolph St",41.88473,-87.627733,1227,1187,0,0,1227,1187,2414,2414,0
"42",45,"Michigan Ave & Ida B Wells Dr",41.876243,-87.624426,445,398,0,0,445,398,843,843,0
"43",46,"Wells St & Walton St",41.89993,-87.63443,675,602,0,0,675,602,1277,1277,0
"44",47,"State St & Kinzie St",41.889187,-87.627754,1320,1335,0,0,1320,1335,2655,2655,0
"45",48,"Larrabee St & Kingsbury St",41.897764,-87.642884,699,709,0,0,699,709,1408,1408,0
"46",49,"Dearborn St & Monroe St",41.881319,-87.62952,1105,1053,0,0,1105,1053,2158,2158,0
"47",50,"Clark St & Ida B Wells Dr",41.875932,-87.630584,345,335,0,0,345,335,680,680,0
"48",51,"Clark St & Randolph St",41.884576,-87.631889,963,955,0,0,963,955,1918,1918,0
"49",52,"Michigan Ave & Lake St",41.886024,-87.624117,1965,1834,0,0,1965,1834,3799,3799,0
"50",53,"Wells St & Huron St",41.894722,-87.634362,2171,2149,0,0,2171,2149,4320,4320,0
"51",54,"Ogden Ave & Chicago Ave",41.896362,-87.654061,862,869,0,0,862,869,1731,1731,0
"52",55,"Halsted St & Roosevelt Rd",41.867324,-87.648625,188,192,0,0,188,192,380,380,0
"53",56,"Desplaines St & Kinzie St",41.888716,-87.644447,2115,2067,0,0,2115,2067,4182,4182,0
"54",57,"Clinton St & Roosevelt Rd",41.867117,-87.641087,608,709,0,0,608,709,1317,1317,0
"55",58,"Marshfield Ave & Cortland St",41.916017,-87.668879,574,568,0,0,574,568,1142,1142,0
"56",59,"Wabash Ave & Roosevelt Rd",41.867227,-87.625961,2373,2519,0,0,2373,2519,4892,4892,0
"57",60,"Dayton St & North Ave",41.910578,-87.649421,753,762,0,0,753,762,1515,1515,0
"58",61,"Wood St & Milwaukee Ave",41.907655,-87.672552,1320,1418,0,0,1320,1418,2738,2738,0
"59",62,"McCormick Place",41.851375,-87.618835,229,214,0,0,229,214,443,443,0
"60",66,"Clinton St & Lake St",41.885637,-87.641823,995,1032,0,0,995,1032,2027,2027,0
"61",67,"Sheffield Ave & Fullerton Ave",41.925601,-87.653708,938,868,0,0,938,868,1806,1806,0
"62",68,"Clinton St & Tilden St",41.875885,-87.640795,215,246,0,0,215,246,461,461,0
"63",69,"Damen Ave & Pierce Ave",41.909396,-87.677691,1786,1956,0,0,1786,1956,3742,3742,0
"64",71,"Morgan St & Lake St",41.885483,-87.652304,1231,1483,0,0,1231,1483,2714,2714,0
"65",72,"Wabash Ave & 16th St",41.860384,-87.625813,878,905,0,0,878,905,1783,1783,0
"66",73,"Jefferson St & Monroe St",41.880422,-87.642746,725,607,0,0,725,607,1332,1332,0
"67",74,"Kingsbury St & Erie St",41.893808,-87.641697,1634,1615,0,0,1634,1615,3249,3249,0
"68",75,"Canal St & Jackson Blvd",41.877245,-87.639366,199,192,0,0,199,192,391,391,0
"69",76,"Lake Shore Dr & Monroe St",41.880958,-87.616743,2557,2397,0,0,2557,2397,4954,4954,0
"70",77,"Clinton St & Madison St",41.882242,-87.641066,1075,981,0,0,1075,981,2056,2056,0
"71",80,"Aberdeen St & Monroe St",41.880419,-87.655519,520,519,0,0,520,519,1039,1039,0
"72",81,"Daley Center Plaza",41.884241,-87.629634,1103,1085,0,0,1103,1085,2188,2188,0
"73",84,"Milwaukee Ave & Grand Ave",41.891578,-87.648384,1478,1547,0,0,1478,1547,3025,3025,0
"74",85,"Michigan Ave & Oak St",41.90096,-87.623776,1822,1804,0,0,1822,1804,3626,3626,0
"75",86,"Eckhart Park",41.896373,-87.660983,871,873,0,0,871,873,1744,1744,0
"76",87,"Racine Ave & Fullerton Ave",41.925562,-87.658404,1054,1079,0,0,1054,1079,2133,2133,0
"77",88,"Racine Ave & Randolph St",41.884069,-87.656853,465,464,0,0,465,464,929,929,0
"78",89,"Financial Pl & Ida B Wells Dr",41.875024,-87.633094,375,366,0,0,375,366,741,741,0
"79",90,"Millennium Park",41.881031,-87.624084,2247,2112,0,0,2247,2112,4359,4359,0
"80",91,"Clinton St & Washington Blvd",41.88338,-87.64117,692,690,0,0,692,690,1382,1382,0
"81",92,"Carpenter St & Huron St",41.894556,-87.653449,898,791,0,0,898,791,1689,1689,0
"82",93,"Sheffield Ave & Willow St",41.913688,-87.652855,1071,1078,0,0,1071,1078,2149,2149,0
"83",94,"Clark St & Armitage Ave",41.918306,-87.636282,2413,2301,0,0,2413,2301,4714,4714,0
"84",95,"Stony Island Ave & 64th St",41.778881,-87.586647,53,56,0,0,53,56,109,109,0
"85",96,"Desplaines St & Randolph St",41.884616,-87.64457,854,862,0,0,854,862,1716,1716,0
"86",97,"Field Museum",41.865312,-87.617867,179,177,0,0,179,177,356,356,0
"87",98,"LaSalle St & Washington St",41.882664,-87.63253,713,750,0,0,713,750,1463,1463,0
"88",99,"Lake Shore Dr & Ohio St",41.89257,-87.614492,1306,1308,0,0,1306,1308,2614,2614,0
"89",100,"Orleans St & Merchandise Mart Plaza",41.888243,-87.63639,552,489,0,0,552,489,1041,1041,0
"90",101,"63rd St Beach",41.781016,-87.576119,314,316,0,0,314,316,630,630,0
"91",102,"Stony Island Ave & 67th St",41.773458,-87.58534,89,87,0,0,89,87,176,176,0
"92",103,"Clinton St & Polk St",41.871466,-87.640949,65,84,0,0,65,84,149,149,0
"93",106,"State St & Pearson St",41.897448,-87.628722,961,880,0,0,961,880,1841,1841,0
"94",107,"Desplaines St & Jackson Blvd",41.878287,-87.643909,972,934,0,0,972,934,1906,1906,0
"95",108,"Halsted St & Polk St",41.87184,-87.64664,158,143,0,0,158,143,301,301,0
"96",109,"900 W Harrison St",41.874754,-87.649807,307,317,0,0,307,317,624,624,0
"97",110,"Dearborn St & Erie St",41.893992,-87.629318,2307,2309,0,0,2307,2309,4616,4616,0
"98",111,"Sedgwick St & Huron St",41.894666,-87.638437,783,802,0,0,783,802,1585,1585,0
"99",112,"Green St & Randolph St",41.883668,-87.64867,994,1072,0,0,994,1072,2066,2066,0
"100",113,"Bissell St & Armitage Ave",41.91844,-87.65222,1520,1669,0,0,1520,1669,3189,3189,0
"101",114,"Sheffield Ave & Waveland Ave",41.949399,-87.654529,1776,1855,0,0,1776,1855,3631,3631,0
"102",115,"Sheffield Ave & Wellington Ave",41.936266,-87.652662,1564,1631,0,0,1564,1631,3195,3195,0
"103",116,"Western Ave & Winnebago Ave",41.91552,-87.687022,832,819,0,0,832,819,1651,1651,0
"104",117,"Wilton Ave & Belmont Ave",41.94018,-87.65304,2146,2209,0,0,2146,2209,4355,4355,0
"105",118,"Sedgwick St & North Ave",41.911386,-87.638677,1054,1033,0,0,1054,1033,2087,2087,0
"106",119,"Ashland Ave & Lake St",41.88592,-87.66717,419,391,0,0,419,391,810,810,0
"107",120,"Wentworth Ave & Cermak Rd",41.853084,-87.631931,524,559,0,0,524,559,1083,1083,0
"108",121,"Blackstone Ave & Hyde Park Blvd",41.802562,-87.590368,527,495,0,0,527,495,1022,1022,0
"109",122,"Ogden Ave & Congress Pkwy",41.87501,-87.67328,135,125,0,0,135,125,260,260,0
"110",123,"California Ave & Milwaukee Ave",41.922695,-87.697153,895,882,0,0,895,882,1777,1777,0
"111",124,"Damen Ave & Cullerton St",41.855048,-87.675726,324,338,0,0,324,338,662,662,0
"112",125,"Rush St & Hubbard St",41.890173,-87.626185,661,666,0,0,661,666,1327,1327,0
"113",126,"Clark St & North Ave",41.911974,-87.631942,1237,1252,0,0,1237,1252,2489,2489,0
"114",127,"Lincoln Ave & Fullerton Ave",41.925905,-87.64926,1679,1683,0,0,1679,1683,3362,3362,0
"115",128,"Damen Ave & Chicago Ave",41.895769,-87.67722,1131,1134,0,0,1131,1134,2265,2265,0
"116",129,"Blue Island Ave & 18th St",41.857556,-87.661535,433,479,0,0,433,479,912,912,0
"117",130,"Damen Ave & Division St",41.903266,-87.678435,794,724,0,0,794,724,1518,1518,0
"118",131,"Lincoln Ave & Belmont Ave",41.939365,-87.668385,754,768,0,0,754,768,1522,1522,0
"119",132,"Wentworth Ave & 24th St (Temp)",41.850083,-87.63214,106,126,0,0,106,126,232,232,0
"120",133,"Kingsbury St & Kinzie St",41.889176,-87.638505,1439,1308,0,0,1439,1308,2747,2747,0
"121",134,"Peoria St & Jackson Blvd",41.877641,-87.649617,990,1037,0,0,990,1037,2027,2027,0
"122",135,"Halsted St & 21st St",41.85378,-87.64665,157,153,0,0,157,153,310,310,0
"123",136,"Racine Ave & 13th St",41.865054,-87.656959,130,123,0,0,130,123,253,253,0
"124",137,"Morgan Ave & 14th Pl",41.862378,-87.651062,391,390,0,0,391,390,781,781,0
"125",138,"Clybourn Ave & Division St",41.904613,-87.640552,677,686,0,0,677,686,1363,1363,0
"126",140,"Dearborn Pkwy & Delaware Pl",41.898969,-87.629912,2152,2143,0,0,2152,2143,4295,4295,0
"127",141,"Clark St & Lincoln Ave",41.915689,-87.6346,2545,2435,0,0,2545,2435,4980,4980,0
"128",142,"McClurg Ct & Erie St",41.894503,-87.617854,1438,1509,0,0,1438,1509,2947,2947,0
"129",143,"Sedgwick St & Webster Ave",41.922167,-87.638888,1134,1116,0,0,1134,1116,2250,2250,0
"130",144,"Larrabee St & Webster Ave",41.921822,-87.64414,2465,2562,0,0,2465,2562,5027,5027,0
"131",145,"Mies van der Rohe Way & Chestnut St",41.898586,-87.621915,1384,1365,0,0,1384,1365,2749,2749,0
"132",146,"Loomis St & Jackson Blvd",41.877945,-87.662007,413,464,0,0,413,464,877,877,0
"133",147,"Indiana Ave & 26th St",41.845687,-87.622481,378,377,0,0,378,377,755,755,0
"134",148,"State St & 33rd St",41.834734,-87.625813,331,329,0,0,331,329,660,660,0
"135",149,"Calumet Ave & 33rd St",41.8349,-87.61793,364,368,0,0,364,368,732,732,0
"136",150,"Fort Dearborn Dr & 31st St",41.838556,-87.608218,1027,1039,0,0,1027,1039,2066,2066,0
"137",152,"Lincoln Ave & Diversey Pkwy",41.932225,-87.658617,932,937,0,0,932,937,1869,1869,0
"138",153,"Southport Ave & Wellington Ave",41.935733,-87.663576,950,935,0,0,950,935,1885,1885,0
"139",154,"Southport Ave & Belmont Ave",41.93949,-87.66378,812,835,0,0,812,835,1647,1647,0
"140",156,"Clark St & Wellington Ave",41.936496,-87.647538,1726,1741,0,0,1726,1741,3467,3467,0
"141",157,"Lake Shore Dr & Wellington Ave",41.936688,-87.636829,2435,2491,0,0,2435,2491,4926,4926,0
"142",158,"Milwaukee Ave & Wabansia Ave",41.912616,-87.681391,1135,1148,0,0,1135,1148,2283,2283,0
"143",159,"Claremont Ave & Hirsch St",41.907781,-87.685854,171,167,0,0,171,167,338,338,0
"144",160,"Campbell Ave & North Ave",41.910535,-87.689556,525,523,0,0,525,523,1048,1048,0
"145",161,"Rush St & Superior St",41.895764,-87.625908,1269,1202,0,0,1269,1202,2471,2471,0
"146",162,"Damen Ave & Wellington Ave",41.93588,-87.67842,532,544,0,0,532,544,1076,1076,0
"147",163,"Damen Ave & Clybourn Ave",41.931931,-87.677856,452,488,0,0,452,488,940,940,0
"148",164,"Franklin St & Lake St",41.885837,-87.6355,1004,973,0,0,1004,973,1977,1977,0
"149",165,"Clark St & Grace St",41.95078,-87.659172,1243,1234,0,0,1243,1234,2477,2477,0
"150",166,"Ashland Ave & Wrightwood Ave",41.92883,-87.668507,588,604,0,0,588,604,1192,1192,0
"151",167,"Damen Ave & Coulter St",41.8492,-87.67564,83,79,0,0,83,79,162,162,0
"152",168,"Michigan Ave & 14th St",41.864059,-87.623727,1329,1287,0,0,1329,1287,2616,2616,0
"153",169,"Canal St & Harrison St",41.874255,-87.639573,166,170,0,0,166,170,336,336,0
"154",170,"Clinton St & 18th St",41.85795,-87.640826,240,239,0,0,240,239,479,479,0
"155",171,"May St & Cullerton St",41.855136,-87.654127,215,209,0,0,215,209,424,424,0
"156",172,"Rush St & Cedar St",41.902308,-87.62769,1904,1918,0,0,1904,1918,3822,3822,0
"157",173,"Mies van der Rohe Way & Chicago Ave",41.89691,-87.621743,1376,1374,0,0,1376,1374,2750,2750,0
"158",174,"Canal St & Madison St",41.882091,-87.639833,421,414,0,0,421,414,835,835,0
"159",175,"Wells St & Polk St",41.872596,-87.633502,856,797,0,0,856,797,1653,1653,0
"160",176,"Clark St & Elm St",41.902973,-87.63128,3348,3301,0,0,3348,3301,6649,6649,0
"161",177,"Theater on the Lake",41.926277,-87.630834,2214,2237,0,0,2214,2237,4451,4451,0
"162",178,"State St & 19th St",41.856594,-87.627542,374,394,0,0,374,394,768,768,0
"163",179,"MLK Jr Dr & Pershing Rd",41.8246,-87.61678,315,306,0,0,315,306,621,621,0
"164",180,"Ritchie Ct & Banks St",41.906866,-87.626217,1219,1164,0,0,1219,1164,2383,2383,0
"165",181,"LaSalle St & Illinois St",41.890762,-87.631697,1464,1456,0,0,1464,1456,2920,2920,0
"166",182,"Wells St & Elm St",41.903222,-87.634324,2486,2221,0,0,2486,2221,4707,4707,0
"167",183,"Damen Ave & Thomas St (Augusta Blvd)",41.901315,-87.677409,745,721,0,0,745,721,1466,1466,0
"168",184,"State St & 35th St",41.8309,-87.62803,233,231,0,0,233,231,464,464,0
"169",185,"Stave St & Armitage Ave",41.917741,-87.691392,389,401,0,0,389,401,790,790,0
"170",186,"Ogden Ave & Race Ave",41.891795,-87.658751,862,891,0,0,862,891,1753,1753,0
"171",188,"Greenview Ave & Fullerton Ave",41.92533,-87.6658,891,931,0,0,891,931,1822,1822,0
"172",190,"Southport Ave & Wrightwood Ave",41.928773,-87.663913,829,858,0,0,829,858,1687,1687,0
"173",191,"Canal St & Monroe St",41.88169,-87.63953,202,182,0,0,202,182,384,384,0
"174",192,"Canal St & Adams St",41.879255,-87.639904,588,586,0,0,588,586,1174,1174,0
"175",193,"State St & 29th St",41.841707,-87.626938,102,96,0,0,102,96,198,198,0
"176",194,"Wabash Ave & Wacker Pl",41.886875,-87.62603,1268,1317,0,0,1268,1317,2585,2585,0
"177",195,"Columbus Dr & Randolph St",41.884728,-87.619521,2058,1554,0,0,2058,1554,3612,3612,0
"178",196,"Cityfront Plaza Dr & Pioneer Ct",41.890573,-87.622072,1021,912,0,0,1021,912,1933,1933,0
"179",197,"Michigan Ave & Madison St",41.882134,-87.625125,697,688,0,0,697,688,1385,1385,0
"180",198,"Green St & Madison St",41.881892,-87.648789,1585,1732,0,0,1585,1732,3317,3317,0
"181",199,"Wabash Ave & Grand Ave",41.891466,-87.626761,2144,2120,0,0,2144,2120,4264,4264,0
"182",200,"MLK Jr Dr & 47th St",41.809851,-87.616279,196,201,0,0,196,201,397,397,0
"183",201,"Indiana Ave & 40th St",41.82168,-87.6216,89,99,0,0,89,99,188,188,0
"184",202,"Halsted St & 18th St",41.857499,-87.646277,253,250,0,0,253,250,503,503,0
"185",203,"Western Ave & 21st St",41.854109,-87.685838,150,147,0,0,150,147,297,297,0
"186",204,"Prairie Ave & Garfield Blvd",41.794853,-87.618691,72,69,0,0,72,69,141,141,0
"187",205,"Paulina St & 18th St",41.857901,-87.668745,393,414,0,0,393,414,807,807,0
"188",206,"Halsted St & Archer Ave",41.847203,-87.646795,147,148,0,0,147,148,295,295,0
"189",207,"Emerald Ave & 28th St",41.84358,-87.645368,280,282,0,0,280,282,562,562,0
"190",208,"Laflin St & Cullerton St",41.854914,-87.663559,228,260,0,0,228,260,488,488,0
"191",209,"Normal Ave & Archer Ave",41.849527,-87.640591,103,100,0,0,103,100,203,203,0
"192",210,"Ashland Ave & Division St",41.90345,-87.667747,1880,1951,0,0,1880,1951,3831,3831,0
"193",211,"St. Clair St & Erie St",41.894448,-87.622663,2004,2104,0,0,2004,2104,4108,4108,0
"194",212,"Wells St & Hubbard St",41.889906,-87.634266,1490,1422,0,0,1490,1422,2912,2912,0
"195",213,"Leavitt St & North Ave",41.910153,-87.68229,550,549,0,0,550,549,1099,1099,0
"196",214,"Damen Ave & Grand Ave",41.89122,-87.67686,422,391,0,0,422,391,813,813,0
"197",215,"Damen Ave & Madison St",41.88137,-87.67493,226,222,0,0,226,222,448,448,0
"198",216,"California Ave & Division St",41.903029,-87.697474,472,541,0,0,472,541,1013,1013,0
"199",217,"Elizabeth (May) St & Fulton St",41.886616,-87.658039,390,404,0,0,390,404,794,794,0
"200",218,"Wells St & 19th St",41.856802,-87.633879,299,294,0,0,299,294,593,593,0
"201",219,"Damen Ave & Cortland St",41.915983,-87.677335,1039,1035,0,0,1039,1035,2074,2074,0
"202",220,"Clark St & Drummond Pl",41.931248,-87.644336,1717,1752,0,0,1717,1752,3469,3469,0
"203",222,"Milwaukee Ave & Rockwell St",41.920195,-87.693033,477,471,0,0,477,471,948,948,0
"204",223,"Clifton Ave & Armitage Ave",41.918216,-87.656936,843,818,0,0,843,818,1661,1661,0
"205",224,"Halsted St & Willow St",41.913865,-87.648755,904,909,0,0,904,909,1813,1813,0
"206",225,"Halsted St & Dickens Ave",41.919936,-87.64883,1380,1475,0,0,1380,1475,2855,2855,0
"207",226,"Racine Ave & Belmont Ave",41.939743,-87.658865,1099,1108,0,0,1099,1108,2207,2207,0
"208",227,"Southport Ave & Waveland Ave",41.94815,-87.66394,1338,1392,0,0,1338,1392,2730,2730,0
"209",228,"Damen Ave & Melrose Ave",41.9406,-87.6785,378,370,0,0,378,370,748,748,0
"210",229,"Southport Ave & Roscoe St",41.943739,-87.66402,1622,1692,0,0,1622,1692,3314,3314,0
"211",230,"Lincoln Ave & Roscoe St",41.94334,-87.67097,795,836,0,0,795,836,1631,1631,0
"212",231,"Sheridan Rd & Montrose Ave",41.96167,-87.65464,1243,1280,0,0,1243,1280,2523,2523,0
"213",232,"Pine Grove Ave & Waveland Ave",41.949868,-87.646061,1781,1739,0,0,1781,1739,3520,3520,0
"214",233,"Sangamon St & Washington Blvd",41.883165,-87.6511,669,698,0,0,669,698,1367,1367,0
"215",234,"Clark St & Montrose Ave",41.961588,-87.666036,511,473,0,0,511,473,984,984,0
"216",236,"Sedgwick St & Schiller St",41.907626,-87.638566,381,400,0,0,381,400,781,781,0
"217",237,"MLK Jr Dr & 29th St",41.842052,-87.617,715,705,0,0,715,705,1420,1420,0
"218",238,"Wolcott (Ravenswood) Ave & Montrose Ave",41.961406,-87.676169,443,445,0,0,443,445,888,888,0
"219",239,"Western Ave & Leland Ave",41.966495,-87.688419,483,509,0,0,483,509,992,992,0
"220",240,"Sheridan Rd & Irving Park Rd",41.954245,-87.654406,1196,1141,0,0,1196,1141,2337,2337,0
"221",241,"Morgan St & Polk St",41.871737,-87.65103,522,522,0,0,522,522,1044,1044,0
"222",242,"Damen Ave & Leland Ave",41.967094,-87.679028,440,440,0,0,440,440,880,880,0
"223",243,"Lincoln Ave & Sunnyside Ave",41.963004,-87.684781,539,555,0,0,539,555,1094,1094,0
"224",244,"Ravenswood Ave & Irving Park Rd",41.95469,-87.67393,413,402,0,0,413,402,815,815,0
"225",245,"Clarendon Ave & Junior Ter",41.961004,-87.649603,1122,1080,0,0,1122,1080,2202,2202,0
"226",246,"Ashland Ave & Belle Plaine Ave",41.956057,-87.668835,288,306,0,0,288,306,594,594,0
"227",247,"Shore Dr & 55th St",41.795212,-87.580715,1116,1126,0,0,1116,1126,2242,2242,0
"228",248,"Woodlawn Ave & 55th St",41.795264,-87.596471,268,259,0,0,268,259,527,527,0
"229",249,"Montrose Harbor",41.963982,-87.638181,1655,1621,0,0,1655,1621,3276,3276,0
"230",250,"Ashland Ave & Wellington Ave",41.936083,-87.669807,545,551,0,0,545,551,1096,1096,0
"231",251,"Clarendon Ave & Leland Ave",41.967968,-87.650001,734,706,0,0,734,706,1440,1440,0
"232",252,"Greenwood Ave & 47th St",41.809835,-87.599383,271,271,0,0,271,271,542,542,0
"233",253,"Winthrop Ave & Lawrence Ave",41.968812,-87.657659,511,481,0,0,511,481,992,992,0
"234",254,"Pine Grove Ave & Irving Park Rd",41.954383,-87.648043,1505,1465,0,0,1505,1465,2970,2970,0
"235",255,"Indiana Ave & Roosevelt Rd",41.867888,-87.623041,2690,2557,0,0,2690,2557,5247,5247,0
"236",256,"Broadway & Sheridan Rd",41.952833,-87.649993,1147,1097,0,0,1147,1097,2244,2244,0
"237",257,"Lincoln Ave & Waveland Ave",41.948797,-87.675278,461,480,0,0,461,480,941,941,0
"238",258,"Logan Blvd & Elston Ave",41.929465,-87.684158,503,558,0,0,503,558,1061,1061,0
"239",259,"California Ave & Francis Pl (Temp)",41.918491,-87.697422,373,381,0,0,373,381,754,754,0
"240",260,"Kedzie Ave & Milwaukee Ave",41.929567,-87.707857,1217,1237,0,0,1217,1237,2454,2454,0
"241",261,"Hermitage Ave & Polk St",41.871514,-87.669886,368,350,0,0,368,350,718,718,0
"242",262,"Halsted St & 37th St",41.827059,-87.64572,57,60,0,0,57,60,117,117,0
"243",263,"Rhodes Ave & 32nd St",41.836208,-87.613533,415,417,0,0,415,417,832,832,0
"244",264,"Stetson Ave & South Water St",41.886835,-87.62232,808,790,0,0,808,790,1598,1598,0
"245",265,"Cottage Grove Ave & Oakwood Blvd",41.822985,-87.6071,269,311,0,0,269,311,580,580,0
"246",267,"Lake Park Ave & 47th St",41.809443,-87.591875,221,223,0,0,221,223,444,444,0
"247",268,"Lake Shore Dr & North Blvd",41.911722,-87.626804,3024,2992,0,0,3024,2992,6016,6016,0
"248",270,"Stony Island Ave & 75th St",41.758669,-87.586882,32,35,0,0,32,35,67,67,0
"249",271,"Cottage Grove Ave & 43rd St",41.816499,-87.606582,188,185,0,0,188,185,373,373,0
"250",272,"Indiana Ave & 31st St",41.838842,-87.621857,267,264,0,0,267,264,531,531,0
"251",273,"Michigan Ave & 18th St",41.857813,-87.62455,889,896,0,0,889,896,1785,1785,0
"252",274,"Racine Ave & 15th St",41.861267,-87.656625,129,120,0,0,129,120,249,249,0
"253",275,"Ashland Ave & 13th St",41.865234,-87.666507,189,197,0,0,189,197,386,386,0
"254",276,"California Ave & North Ave",41.91044,-87.6972,505,502,0,0,505,502,1007,1007,0
"255",277,"Ashland Ave & Grand Ave",41.891072,-87.666611,482,487,0,0,482,487,969,969,0
"256",278,"Wallace St & 35th St",41.830629,-87.64129,144,158,0,0,144,158,302,302,0
"257",279,"Halsted St & 35th St",41.830661,-87.647172,144,150,0,0,144,150,294,294,0
"258",280,"Morgan St & 31st St",41.8378,-87.65114,214,216,0,0,214,216,430,430,0
"259",281,"Western Ave & 24th St",41.84847,-87.685109,112,111,0,0,112,111,223,223,0
"260",282,"Halsted St & Maxwell St",41.864883,-87.647071,472,477,0,0,472,477,949,949,0
"261",283,"LaSalle St & Jackson Blvd",41.878166,-87.631929,638,552,0,0,638,552,1190,1190,0
"262",284,"Michigan Ave & Jackson Blvd",41.87785,-87.62408,712,655,0,0,712,655,1367,1367,0
"263",285,"Wood St & Hubbard St",41.889899,-87.671473,302,309,0,0,302,309,611,611,0
"264",286,"Franklin St & Adams St (Temp)",41.879434,-87.635504,294,288,0,0,294,288,582,582,0
"265",287,"Franklin St & Monroe St",41.880317,-87.635185,770,726,0,0,770,726,1496,1496,0
"266",288,"Larrabee St & Armitage Ave",41.918084,-87.643749,906,927,0,0,906,927,1833,1833,0
"267",289,"Wells St & Concord Ln",41.912133,-87.634656,2603,2554,0,0,2603,2554,5157,5157,0
"268",290,"Kedzie Ave & Palmer Ct",41.921525,-87.707322,419,421,0,0,419,421,840,840,0
"269",291,"Wells St & Evergreen Ave",41.906724,-87.63483,2251,2263,0,0,2251,2263,4514,4514,0
"270",292,"Southport Ave & Clark St",41.957081,-87.664199,354,344,0,0,354,344,698,698,0
"271",293,"Broadway & Wilson Ave",41.965221,-87.658139,940,1006,0,0,940,1006,1946,1946,0
"272",294,"Broadway & Berwyn Ave",41.978353,-87.659753,831,842,0,0,831,842,1673,1673,0
"273",295,"Broadway & Argyle St",41.973815,-87.65966,745,689,0,0,745,689,1434,1434,0
"274",296,"Broadway & Belmont Ave",41.940106,-87.645451,1455,1479,0,0,1455,1479,2934,2934,0
"275",297,"Paulina St & Montrose Ave",41.961507,-87.671387,320,303,0,0,320,303,623,623,0
"276",298,"Lincoln Ave & Belle Plaine Ave",41.956003,-87.680161,480,512,0,0,480,512,992,992,0
"277",299,"Halsted St & Roscoe St",41.94367,-87.64895,2093,2110,0,0,2093,2110,4203,4203,0
"278",300,"Broadway & Barry Ave",41.937725,-87.644095,2643,2684,0,0,2643,2684,5327,5327,0
"279",301,"Clark St & Schiller St",41.907993,-87.631501,2057,1716,0,0,2057,1716,3773,3773,0
"280",302,"Sheffield Ave & Wrightwood Ave",41.928712,-87.653833,1341,1351,0,0,1341,1351,2692,2692,0
"281",303,"Broadway & Cornelia Ave",41.945529,-87.646439,2102,2144,0,0,2102,2144,4246,4246,0
"282",304,"Broadway & Waveland Ave",41.949074,-87.648636,1625,1648,0,0,1625,1648,3273,3273,0
"283",305,"Western Ave & Division St",41.902893,-87.687275,439,390,0,0,439,390,829,829,0
"284",306,"Sheridan Rd & Buena Ave",41.958494,-87.654966,754,709,0,0,754,709,1463,1463,0
"285",307,"Southport Ave & Clybourn Ave",41.920771,-87.663712,460,477,0,0,460,477,937,937,0
"286",308,"Seeley Ave & Roscoe St",41.943403,-87.679618,472,475,0,0,472,475,947,947,0
"287",309,"Leavitt St & Armitage Ave",41.917805,-87.682437,528,528,0,0,528,528,1056,1056,0
"288",310,"Damen Ave & Charleston St",41.920082,-87.677855,487,469,0,0,487,469,956,956,0
"289",311,"Leavitt St & Lawrence Ave",41.968885,-87.684001,252,250,0,0,252,250,502,502,0
"290",312,"Clarendon Ave & Gordon Ter",41.957879,-87.649519,1073,1041,0,0,1073,1041,2114,2114,0
"291",313,"Lakeview Ave & Fullerton Pkwy",41.925858,-87.638973,2343,2295,0,0,2343,2295,4638,4638,0
"292",314,"Ravenswood Ave & Berteau Ave",41.957921,-87.673567,206,204,0,0,206,204,410,410,0
"293",315,"Elston Ave & Wabansia Ave",41.912919,-87.664169,344,342,0,0,344,342,686,686,0
"294",316,"Damen Ave & Sunnyside Ave",41.96325,-87.679258,356,349,0,0,356,349,705,705,0
"295",317,"Wood St & Taylor St",41.869154,-87.671045,519,506,0,0,519,506,1025,1025,0
"296",318,"Southport Ave & Irving Park Rd",41.954177,-87.664358,622,611,0,0,622,611,1233,1233,0
"297",319,"Greenview Ave & Diversey Pkwy",41.932589,-87.665936,450,447,0,0,450,447,897,897,0
"298",320,"Loomis St & Lexington St",41.872187,-87.661501,1008,973,0,0,1008,973,1981,1981,0
"299",321,"Wabash Ave & 9th St",41.870769,-87.625734,1476,1489,0,0,1476,1489,2965,2965,0
"300",322,"Kimbark Ave & 53rd St",41.799568,-87.594747,754,739,0,0,754,739,1493,1493,0
"301",323,"Sheridan Rd & Lawrence Ave",41.969517,-87.654691,583,563,0,0,583,563,1146,1146,0
"302",324,"Stockton Dr & Wrightwood Ave",41.93132,-87.638742,1975,1955,0,0,1975,1955,3930,3930,0
"303",325,"Clark St & Winnemac Ave",41.97334,-87.66778,876,907,0,0,876,907,1783,1783,0
"304",326,"Clark St & Leland Ave",41.967096,-87.667429,741,739,0,0,741,739,1480,1480,0
"305",327,"Sheffield Ave & Webster Ave",41.92154,-87.653818,1340,1382,0,0,1340,1382,2722,2722,0
"306",328,"Ellis Ave & 58th St",41.788746,-87.601334,241,242,0,0,241,242,483,483,0
"307",329,"Lake Shore Dr & Diversey Pkwy",41.932588,-87.636427,2299,2321,0,0,2299,2321,4620,4620,0
"308",330,"Lincoln Ave & Addison St",41.946176,-87.673308,301,311,0,0,301,311,612,612,0
"309",331,"Halsted St & Clybourn Ave",41.909668,-87.648128,1180,1223,0,0,1180,1223,2403,2403,0
"310",332,"Burling St (Halsted) & Diversey Pkwy (Temp)",41.93314,-87.64776,1214,1257,0,0,1214,1257,2471,2471,0
"311",333,"Ashland Ave & Blackhawk St",41.907066,-87.667252,1022,1019,0,0,1022,1019,2041,2041,0
"312",334,"Lake Shore Dr & Belmont Ave",41.940775,-87.639192,2008,2010,0,0,2008,2010,4018,4018,0
"313",335,"Calumet Ave & 35th St",41.831379,-87.618034,195,187,0,0,195,187,382,382,0
"314",336,"Cottage Grove Ave & 47th St",41.809855,-87.606755,162,146,0,0,162,146,308,308,0
"315",337,"Clark St & Chicago Ave",41.89675,-87.63089,1211,1184,0,0,1211,1184,2395,2395,0
"316",338,"Calumet Ave & 18th St",41.857611,-87.619407,814,822,0,0,814,822,1636,1636,0
"317",339,"Emerald Ave & 31st St",41.838198,-87.645143,349,348,0,0,349,348,697,697,0
"318",340,"Clark St & Wrightwood Ave",41.929546,-87.643118,1846,1878,0,0,1846,1878,3724,3724,0
"319",341,"Adler Planetarium",41.866095,-87.607267,862,808,0,0,862,808,1670,1670,0
"320",342,"Wolcott Ave & Polk St",41.871262,-87.673688,731,670,0,0,731,670,1401,1401,0
"321",343,"Racine Ave & Wrightwood Ave",41.928887,-87.658971,534,527,0,0,534,527,1061,1061,0
"322",344,"Ravenswood Ave & Lawrence Ave",41.96909,-87.674237,770,793,0,0,770,793,1563,1563,0
"323",345,"Lake Park Ave & 56th St",41.793242,-87.587782,521,511,0,0,521,511,1032,1032,0
"324",346,"Ada St & Washington Blvd",41.88283,-87.661206,630,611,0,0,630,611,1241,1241,0
"325",347,"Ashland Ave & Grace St",41.950687,-87.6687,570,584,0,0,570,584,1154,1154,0
"326",348,"California Ave & 21st St",41.853804,-87.695742,108,104,0,0,108,104,212,212,0
"327",349,"Halsted St & Wrightwood Ave",41.929143,-87.649077,1377,1364,0,0,1377,1364,2741,2741,0
"328",350,"Ashland Ave & Chicago Ave",41.895966,-87.667747,757,747,0,0,757,747,1504,1504,0
"329",351,"Cottage Grove Ave & 51st St",41.803038,-87.606615,223,229,0,0,223,229,452,452,0
"330",352,"Jeffery Blvd & 67th St",41.773517,-87.577142,149,144,0,0,149,144,293,293,0
"331",353,"Clark St & Touhy Ave",42.01256,-87.674367,106,95,0,0,106,95,201,201,0
"332",354,"Sheridan Rd & Greenleaf Ave",42.010586,-87.662412,365,369,0,0,365,369,734,734,0
"333",355,"South Shore Dr & 67th St",41.773643,-87.567514,298,301,0,0,298,301,599,599,0
"334",356,"Stony Island Ave & 71st St",41.766493,-87.586461,71,66,0,0,71,66,137,137,0
"335",359,"Larrabee St & Division St",41.903486,-87.643353,722,794,0,0,722,794,1516,1516,0
"336",364,"Larrabee St & Oak St",41.900219,-87.642985,586,584,0,0,586,584,1170,1170,0
"337",365,"Halsted St & North Branch St",41.899368,-87.648479,172,179,0,0,172,179,351,351,0
"338",366,"Loomis St & Archer Ave",41.841632,-87.657434,123,120,0,0,123,120,243,243,0
"339",367,"Racine Ave & 35th St",41.830696,-87.655976,96,89,0,0,96,89,185,185,0
"340",368,"Ashland Ave & Archer Ave",41.839208,-87.665609,70,72,0,0,70,72,142,142,0
"341",369,"Wood St & 35th St",41.830104,-87.670298,73,78,0,0,73,78,151,151,0
"342",370,"Calumet Ave & 21st St",41.854184,-87.619153,295,282,0,0,295,282,577,577,0
"343",373,"Kedzie Ave & Chicago Ave",41.895465,-87.706127,89,99,0,0,89,99,188,188,0
"344",374,"Western Ave & Walton St",41.898417,-87.686596,616,587,0,0,616,587,1203,1203,0
"345",375,"Sacramento Blvd & Franklin Blvd",41.890468,-87.702607,63,65,0,0,63,65,128,128,0
"346",376,"Artesian Ave & Hubbard St",41.889491,-87.688219,246,205,0,0,246,205,451,451,0
"347",377,"Kedzie Ave & Lake St",41.884603,-87.706303,111,117,0,0,111,117,228,228,0
"348",378,"California Ave & Lake St",41.884454,-87.696298,81,84,0,0,81,84,165,165,0
"349",381,"Western Ave & Monroe St",41.879787,-87.686112,228,242,0,0,228,242,470,470,0
"350",382,"Western Ave & Congress Pkwy",41.874749,-87.686445,318,309,0,0,318,309,627,627,0
"351",383,"Paulina St & Flournoy St",41.87295,-87.66913,496,454,0,0,496,454,950,950,0
"352",384,"Halsted St & 51st St",41.801832,-87.645214,28,31,0,0,28,31,59,59,0
"353",385,"Princeton Ave & Garfield Blvd",41.794982,-87.633124,24,22,0,0,24,22,46,46,0
"354",386,"Halsted St & 56th St",41.79293,-87.64499,15,19,0,0,15,19,34,34,0
"355",388,"Halsted St & 63rd St",41.779381,-87.644621,49,47,0,0,49,47,96,96,0
"356",390,"Wentworth Ave & 63rd St",41.78008,-87.629746,18,17,0,0,18,17,35,35,0
"357",391,"Halsted St & 69th St",41.769061,-87.644613,22,20,0,0,22,20,42,42,0
"358",392,"Perry Ave & 69th St",41.769293,-87.628196,16,15,0,0,16,15,31,31,0
"359",393,"Calumet Ave & 71st St",41.765508,-87.616918,27,28,0,0,27,28,55,55,0
"360",394,"Clark St & 9th St (AMLI)",41.870816,-87.631246,464,470,0,0,464,470,934,934,0
"361",395,"Jeffery Blvd & 76th St",41.75712,-87.575839,43,45,0,0,43,45,88,88,0
"362",396,"Yates Blvd & 75th St",41.758768,-87.56644,46,43,0,0,46,43,89,89,0
"363",398,"Rainbow Beach",41.757871,-87.549386,72,75,0,0,72,75,147,147,0
"364",399,"South Shore Dr & 74th St",41.762189,-87.559275,122,124,0,0,122,124,246,246,0
"365",400,"Cottage Grove Ave & 71st St",41.765719,-87.604959,4,10,0,0,4,10,14,14,0
"366",401,"Shields Ave & 28th Pl",41.842733,-87.635491,78,77,0,0,78,77,155,155,0
"367",402,"Shields Ave & 31st St",41.838464,-87.635406,140,142,0,0,140,142,282,282,0
"368",403,"Wentworth Ave & 33rd St",41.83453,-87.631823,76,77,0,0,76,77,153,153,0
"369",405,"Wentworth Ave & 35th St",41.830777,-87.632504,60,54,0,0,60,54,114,114,0
"370",406,"Lake Park Ave & 35th St",41.831274,-87.608799,521,532,0,0,521,532,1053,1053,0
"371",407,"State St & Pershing Rd",41.823015,-87.626568,36,29,0,0,36,29,65,65,0
"372",408,"Union Ave & Root St",41.819102,-87.643278,42,43,0,0,42,43,85,85,0
"373",409,"Shields Ave & 43rd St",41.816207,-87.634819,9,5,0,0,9,5,14,14,0
"374",410,"Prairie Ave & 43rd St",41.816659,-87.619412,139,137,0,0,139,137,276,276,0
"375",411,"Halsted St & 47th Pl",41.808133,-87.645616,77,78,0,0,77,78,155,155,0
"376",412,"Princeton Ave & 47th St",41.809317,-87.633449,61,57,0,0,61,57,118,118,0
"377",413,"Woodlawn Ave & Lake Park Ave",41.814093,-87.597005,240,252,0,0,240,252,492,492,0
"378",414,"Canal St & Taylor St",41.870257,-87.639474,261,282,0,0,261,282,543,543,0
"379",415,"Calumet Ave & 51st St",41.802294,-87.618053,148,142,0,0,148,142,290,290,0
"380",416,"Dorchester Ave & 49th St",41.805772,-87.592464,121,123,0,0,121,123,244,244,0
"381",417,"Cornell Ave & Hyde Park Blvd",41.802406,-87.586924,831,816,0,0,831,816,1647,1647,0
"382",418,"Ellis Ave & 53rd St",41.799336,-87.600958,416,413,0,0,416,413,829,829,0
"383",419,"Lake Park Ave & 53rd St",41.799494,-87.58645,498,502,0,0,498,502,1000,1000,0
"384",420,"Ellis Ave & 55th St",41.7943,-87.601449,205,202,0,0,205,202,407,407,0
"385",421,"MLK Jr Dr & 56th St",41.793429,-87.615853,55,57,0,0,55,57,112,112,0
"386",422,"DuSable Museum",41.791568,-87.607852,124,129,0,0,124,129,253,253,0
"387",423,"University Ave & 57th St",41.791478,-87.599861,423,411,0,0,423,411,834,834,0
"388",424,"Museum of Science and Industry",41.791728,-87.583945,386,381,0,0,386,381,767,767,0
"389",425,"Harper Ave & 59th St",41.787943,-87.588315,191,189,0,0,191,189,380,380,0
"390",426,"Ellis Ave & 60th St",41.785097,-87.601073,306,302,0,0,306,302,608,608,0
"391",427,"Cottage Grove Ave & 63rd St",41.780599,-87.606112,81,84,0,0,81,84,165,165,0
"392",428,"Dorchester Ave & 63rd St",41.780405,-87.591415,158,165,0,0,158,165,323,323,0
"393",429,"Cottage Grove Ave & 67th St",41.773721,-87.605635,52,58,0,0,52,58,110,110,0
"394",430,"MLK Jr Dr & 63rd St",41.78008,-87.615942,41,42,0,0,41,42,83,83,0
"395",431,"Eberhart Ave & 61st St",41.784141,-87.613307,82,81,0,0,82,81,163,163,0
"396",432,"Clark St & Lunt Ave",42.009074,-87.67419,180,182,0,0,180,182,362,362,0
"397",433,"Kedzie Ave & Harrison St",41.873599,-87.70487,32,32,0,0,32,32,64,64,0
"398",434,"Ogden Ave & Roosevelt Rd",41.866501,-87.684697,209,202,0,0,209,202,411,411,0
"399",435,"Kedzie Ave & Roosevelt Rd",41.866493,-87.706496,25,26,0,0,25,26,51,51,0
"400",436,"Fairfield Ave & Roosevelt Rd",41.866624,-87.694521,42,62,0,0,42,62,104,104,0
"401",437,"Washtenaw Ave & Ogden Ave",41.86193,-87.69345,64,54,0,0,64,54,118,118,0
"402",438,"Central Park Ave & Ogden Ave",41.854064,-87.715117,55,57,0,0,55,57,112,112,0
"403",439,"Kedzie Ave & 21st St",41.853533,-87.705073,21,24,0,0,21,24,45,45,0
"404",440,"Central Park Ave & 24th St",41.8481,-87.715068,8,16,0,0,8,16,24,24,0
"405",441,"Kedzie Ave & 24th St",41.84819,-87.705413,50,47,0,0,50,47,97,97,0
"406",442,"California Ave & 23rd Pl",41.849109,-87.695139,113,110,0,0,113,110,223,223,0
"407",443,"Millard Ave & 26th St",41.844566,-87.71591,49,48,0,0,49,48,97,97,0
"408",444,"Albany Ave & 26th St",41.844475,-87.702013,55,63,0,0,55,63,118,118,0
"409",445,"California Ave & 26th St",41.84404,-87.695295,19,19,0,0,19,19,38,38,0
"410",446,"Western Ave & 28th St",41.841518,-87.685131,48,42,0,0,48,42,90,90,0
"411",447,"Glenwood Ave & Morse Ave",42.007971,-87.665502,438,439,0,0,438,439,877,877,0
"412",448,"Warren Park East",42.00455,-87.680666,156,160,0,0,156,160,316,316,0
"413",449,"Clark St & Columbia Ave",42.00445,-87.672402,144,147,0,0,144,147,291,291,0
"414",450,"Warren Park West",42.001785,-87.688829,192,187,0,0,192,187,379,379,0
"415",451,"Sheridan Rd & Loyola Ave",42.001044,-87.661198,497,518,0,0,497,518,1015,1015,0
"416",452,"Western Ave & Granville Ave",41.994161,-87.689438,165,164,0,0,165,164,329,329,0
"417",453,"Clark St & Schreiber Ave",41.999251,-87.671377,270,279,0,0,270,279,549,549,0
"418",454,"Broadway & Granville Ave",41.994779,-87.660284,894,893,0,0,894,893,1787,1787,0
"419",455,"Maplewood Ave & Peterson Ave",41.990236,-87.693369,85,89,0,0,85,89,174,174,0
"420",456,"2112 W Peterson Ave",41.991178,-87.683593,112,120,0,0,112,120,232,232,0
"421",457,"Clark St & Elmdale Ave",41.990518,-87.669834,344,342,0,0,344,342,686,686,0
"422",458,"Broadway & Thorndale Ave",41.989742,-87.66014,700,742,0,0,700,742,1442,1442,0
"423",459,"Lakefront Trail & Bryn Mawr Ave",41.984036,-87.65231,1870,1898,0,0,1870,1898,3768,3768,0
"424",460,"Clark St & Bryn Mawr Ave",41.983593,-87.669154,601,631,0,0,601,631,1232,1232,0
"425",461,"Broadway & Ridge Ave",41.984044,-87.660273,830,804,0,0,830,804,1634,1634,0
"426",462,"Winchester (Ravenswood) Ave & Balmoral Ave",41.979762,-87.67753,179,172,0,0,179,172,351,351,0
"427",463,"Clark St & Berwyn Ave",41.977996,-87.668047,965,1003,0,0,965,1003,1968,1968,0
"428",464,"Damen Ave & Foster Ave",41.975614,-87.679459,401,400,0,0,401,400,801,801,0
"429",465,"Marine Dr & Ainslie St",41.9716,-87.650154,1108,1059,0,0,1108,1059,2167,2167,0
"430",466,"Ridge Blvd & Touhy Ave",42.012132,-87.682912,51,49,0,0,51,49,100,100,0
"431",467,"Western Ave & Lunt Ave",42.008594,-87.690492,201,193,0,0,201,193,394,394,0
"432",468,"Budlong Woods Library",41.983664,-87.696422,120,134,0,0,120,134,254,254,0
"433",469,"St. Louis Ave & Balmoral Ave",41.980394,-87.716114,140,132,0,0,140,132,272,272,0
"434",470,"Kedzie Ave & Foster Ave",41.975672,-87.709261,177,181,0,0,177,181,358,358,0
"435",471,"Francisco Ave & Foster Ave",41.975633,-87.701419,267,287,0,0,267,287,554,554,0
"436",472,"Lincoln Ave & Winona St",41.974911,-87.692502,226,224,0,0,226,224,450,450,0
"437",474,"Christiana Ave & Lawrence Ave",41.968354,-87.711831,144,145,0,0,144,145,289,289,0
"438",475,"Washtenaw Ave & Lawrence Ave",41.968987,-87.696027,289,279,0,0,289,279,568,568,0
"439",476,"Kedzie Ave & Leland Ave",41.966686,-87.708051,148,169,0,0,148,169,317,317,0
"440",477,"Manor Ave & Leland Ave",41.965875,-87.700825,193,198,0,0,193,198,391,391,0
"441",478,"Rockwell St & Eastwood Ave",41.9659,-87.693638,221,211,0,0,221,211,432,432,0
"442",479,"Drake Ave & Montrose Ave",41.961154,-87.716569,118,116,0,0,118,116,234,234,0
"443",480,"Albany Ave & Montrose Ave",41.961041,-87.705866,201,207,0,0,201,207,408,408,0
"444",481,"California Ave & Montrose Ave",41.961068,-87.695439,488,501,0,0,488,501,989,989,0
"445",482,"Campbell Ave & Montrose Ave",41.961525,-87.691165,240,237,0,0,240,237,477,477,0
"446",483,"Avondale Ave & Irving Park Rd",41.953393,-87.732002,120,121,0,0,120,121,241,241,0
"447",484,"Monticello Ave & Irving Park Rd",41.954005,-87.719128,116,122,0,0,116,122,238,238,0
"448",485,"Sawyer Ave & Irving Park Rd",41.953586,-87.70931,143,149,0,0,143,149,292,292,0
"449",486,"Oakley Ave & Irving Park Rd",41.95434,-87.686079,221,204,0,0,221,204,425,425,0
"450",487,"California Ave & Byron St",41.952162,-87.698051,263,262,0,0,263,262,525,525,0
"451",488,"Pulaski Rd & Eddy St (Temp)",41.946264,-87.731023,92,98,0,0,92,98,190,190,0
"452",489,"Drake Ave & Addison St",41.947326,-87.717582,57,59,0,0,57,59,116,116,0
"453",490,"Troy St & Elston Ave",41.945243,-87.706649,217,204,0,0,217,204,421,421,0
"454",491,"Talman Ave & Addison St",41.946635,-87.694614,262,248,0,0,262,248,510,510,0
"455",492,"Leavitt St & Addison St",41.946655,-87.683359,202,203,0,0,202,203,405,405,0
"456",493,"Western Ave & Roscoe St",41.943034,-87.687288,323,334,0,0,323,334,657,657,0
"457",494,"Kedzie Ave & Bryn Mawr Ave",41.982397,-87.708923,134,135,0,0,134,135,269,269,0
"458",495,"Keystone Ave & Montrose Ave",41.961108,-87.72897,142,149,0,0,142,149,291,291,0
"459",496,"Avers Ave & Belmont Ave",41.939408,-87.723574,219,214,0,0,219,214,433,433,0
"460",497,"Kimball Ave & Belmont Ave",41.939398,-87.711561,193,189,0,0,193,189,382,382,0
"461",498,"California Ave & Fletcher St",41.938428,-87.698007,253,262,0,0,253,262,515,515,0
"462",499,"Kosciuszko Park",41.930585,-87.723777,234,250,0,0,234,250,484,484,0
"463",500,"Central Park Ave & Elbridge Ave",41.935337,-87.716889,167,155,0,0,167,155,322,322,0
"464",501,"Richmond St & Diversey Ave",41.931901,-87.701195,210,207,0,0,210,207,417,417,0
"465",502,"California Ave & Altgeld St",41.92669,-87.697668,372,374,0,0,372,374,746,746,0
"466",503,"Drake Ave & Fullerton Ave",41.924398,-87.715441,413,430,0,0,413,430,843,843,0
"467",504,"Campbell Ave & Fullerton Ave",41.924632,-87.689307,403,403,0,0,403,403,806,806,0
"468",505,"Winchester Ave & Elston Ave",41.92409,-87.67646,309,305,0,0,309,305,614,614,0
"469",506,"Spaulding Ave & Armitage Ave",41.917108,-87.71022,289,274,0,0,289,274,563,563,0
"470",507,"Humboldt Blvd & Armitage Ave",41.917513,-87.701808,555,555,0,0,555,555,1110,1110,0
"471",508,"Central Park Ave & North Ave",41.909656,-87.716631,141,145,0,0,141,145,286,286,0
"472",509,"Troy St & North Ave",41.909769,-87.70528,546,545,0,0,546,545,1091,1091,0
"473",510,"Spaulding Ave & Division St",41.902706,-87.709219,268,262,0,0,268,262,530,530,0
"474",511,"Albany Ave & Bloomingdale Ave",41.914026,-87.705126,274,273,0,0,274,273,547,547,0
"475",514,"Ridge Blvd & Howard St",42.019276,-87.68452,65,70,0,0,65,70,135,135,0
"476",515,"Paulina St & Howard St",42.019159,-87.673573,159,141,0,0,159,141,300,300,0
"477",517,"Clark St & Jarvis Ave",42.015963,-87.675005,117,109,0,0,117,109,226,226,0
"478",518,"Conservatory Dr & Lake St",41.885502,-87.716866,81,69,0,0,81,69,150,150,0
"479",519,"Wolcott Ave & Fargo Ave",42.016977,-87.677725,33,27,0,0,33,27,60,60,0
"480",520,"Greenview Ave & Jarvis Ave",42.015962,-87.66857,249,241,0,0,249,241,490,490,0
"481",522,"Bosworth Ave & Howard St",42.019537,-87.669563,50,49,0,0,50,49,99,99,0
"482",523,"Eastlake Ter & Rogers Ave",42.020887,-87.665057,290,283,0,0,290,283,573,573,0
"483",524,"Austin Blvd & Chicago Ave",41.894887,-87.774704,52,51,0,0,52,51,103,103,0
"484",525,"Glenwood Ave & Touhy Ave",42.012701,-87.666058,159,163,0,0,159,163,322,322,0
"485",526,"Oakley Ave & Touhy Ave",42.012342,-87.688243,59,62,0,0,59,62,121,121,0
"486",527,"Western Ave & Howard St",42.018901,-87.690048,70,64,0,0,70,64,134,134,0
"487",528,"Pulaski Rd & Lake St",41.885409,-87.726491,20,14,0,0,20,14,34,34,0
"488",529,"Cicero Ave & Lake St",41.886841,-87.745261,8,3,0,0,8,3,11,11,0
"489",530,"Laramie Ave & Kinzie St",41.887832,-87.755527,14,11,0,0,14,11,25,25,0
"490",531,"Central Ave & Lake St",41.887664,-87.765469,34,30,0,0,34,30,64,64,0
"491",532,"Austin Blvd & Lake St",41.887919,-87.774446,84,89,0,0,84,89,173,173,0
"492",533,"Central Park Blvd & 5th Ave",41.875679,-87.71547,34,30,0,0,34,30,64,64,0
"493",534,"Karlov Ave & Madison St",41.88085,-87.727907,29,30,0,0,29,30,59,59,0
"494",535,"Pulaski Rd & Congress Pkwy",41.874325,-87.725704,18,29,0,0,18,29,47,47,0
"495",536,"Kostner Ave & Lake St",41.885928,-87.73541,3,1,0,0,3,1,4,4,0
"496",537,"Kenton Ave & Madison St",41.880708,-87.741018,21,23,0,0,21,23,44,44,0
"497",538,"Cicero Ave & Flournoy St",41.872131,-87.746619,11,16,0,0,11,16,27,27,0
"498",539,"Cicero Ave & Quincy St",41.877613,-87.745405,33,31,0,0,33,31,64,64,0
"499",540,"Laramie Ave & Madison St",41.880207,-87.755337,28,30,0,0,28,30,58,58,0
"500",541,"Central Ave & Harrison St",41.872993,-87.764499,36,34,0,0,36,34,70,70,0
"501",542,"Central Ave & Madison St",41.880121,-87.763238,50,50,0,0,50,50,100,100,0
"502",543,"Laramie Ave & Gladys Ave",41.875806,-87.755285,4,4,0,0,4,4,8,8,0
"503",544,"Austin Blvd & Madison St",41.880281,-87.774453,73,68,0,0,73,68,141,141,0
"504",545,"Kostner Ave & Adams St",41.877917,-87.735737,42,44,0,0,42,44,86,86,0
"505",546,"Damen Ave & Pershing Rd",41.823192,-87.676597,91,89,0,0,91,89,180,180,0
"506",547,"Ashland Ave & Pershing Rd",41.823465,-87.665577,36,41,0,0,36,41,77,77,0
"507",548,"Morgan St & Pershing Rd",41.823613,-87.650931,18,17,0,0,18,17,35,35,0
"508",549,"Marshfield Ave & 44th St",41.813996,-87.666589,12,12,0,0,12,12,24,24,0
"509",550,"Central Ave & Chicago Ave",41.894958,-87.764902,65,62,0,0,65,62,127,127,0
"510",551,"Hoyne Ave & 47th St",41.808227,-87.67718,19,19,0,0,19,19,38,38,0
"511",552,"Ashland Ave & McDowell Ave",41.80887,-87.66454,30,25,0,0,30,25,55,55,0
"512",553,"Elizabeth St & 47th St",41.80839,-87.656526,26,21,0,0,26,21,47,47,0
"513",554,"Damen Ave & 51st St",41.800908,-87.674684,9,7,0,0,9,7,16,16,0
"514",555,"Ashland Ave & 50th St",41.803023,-87.664699,10,14,0,0,10,14,24,24,0
"515",556,"Throop St & 52nd St",41.799659,-87.657195,13,13,0,0,13,13,26,26,0
"516",557,"Seeley Ave & Garfield Blvd",41.794087,-87.675478,8,19,0,0,8,19,27,27,0
"517",558,"Ashland Ave & Garfield Blvd",41.792822,-87.664429,14,16,0,0,14,16,30,30,0
"518",559,"Racine Ave & Garfield Blvd",41.794228,-87.655073,53,56,0,0,53,56,109,109,0
"519",560,"Marshfield Ave & 59th St",41.786833,-87.666215,7,6,0,0,7,6,13,13,0
"520",561,"Damen Ave & 59th St",41.78602,-87.674167,17,18,0,0,17,18,35,35,0
"521",562,"Racine Ave & 61st St",41.783189,-87.654372,4,3,0,0,4,3,7,7,0
"522",563,"Ashland Ave & 63rd St",41.779374,-87.664843,12,12,0,0,12,12,24,24,0
"523",564,"Racine Ave & 65th St",41.775393,-87.654308,16,15,0,0,16,15,31,31,0
"524",565,"Ashland Ave & 66th St",41.774074,-87.663815,2,3,0,0,2,3,5,5,0
"525",566,"Ashland Ave & 69th St",41.768726,-87.664069,16,17,0,0,16,17,33,33,0
"526",567,"May St & 69th St",41.768938,-87.652934,6,11,0,0,6,11,17,17,0
"527",568,"Vincennes Ave & 75th St",41.75797,-87.63121,15,15,0,0,15,15,30,30,0
"528",569,"Woodlawn Ave & 75th St",41.75916,-87.595751,6,6,0,0,6,6,12,12,0
"529",570,"Evans Ave & 75th St",41.75849,-87.60641,14,7,0,0,14,7,21,21,0
"530",571,"Vernon Ave & 75th St",41.758361,-87.614138,26,26,0,0,26,26,52,52,0
"531",572,"State St & 76th St",41.756971,-87.624621,9,4,0,0,9,4,13,13,0
"532",573,"State St & 79th St",41.750794,-87.624424,20,20,0,0,20,20,40,40,0
"533",574,"Vernon Ave & 79th St",41.75094,-87.61379,18,16,0,0,18,16,34,34,0
"534",575,"Cottage Grove Ave & 78th St",41.753174,-87.605026,56,54,0,0,56,54,110,110,0
"535",576,"Greenwood Ave & 79th St",41.751294,-87.597552,19,20,0,0,19,20,39,39,0
"536",577,"Stony Island Ave & South Chicago Ave",41.751173,-87.585337,15,17,0,0,15,17,32,32,0
"537",578,"Bennett Ave & 79th St",41.751785,-87.578496,7,8,0,0,7,8,15,15,0
"538",579,"Phillips Ave & 79th St",41.75182,-87.565211,29,28,0,0,29,28,57,57,0
"539",580,"Exchange Ave & 79th St",41.751731,-87.552812,23,32,0,0,23,32,55,55,0
"540",581,"Commercial Ave & 83rd St",41.744615,-87.551208,29,26,0,0,29,26,55,55,0
"541",582,"Phillips Ave & 83rd St",41.744531,-87.56506,48,44,0,0,48,44,92,92,0
"542",583,"Stony Island Ave & 82nd St",41.746559,-87.586005,16,15,0,0,16,15,31,31,0
"543",584,"Ellis Ave & 83rd St",41.744123,-87.599034,32,33,0,0,32,33,65,65,0
"544",585,"Cottage Grove Ave & 83rd St",41.743441,-87.604836,48,51,0,0,48,51,99,99,0
"545",586,"MLK Jr Dr & 83rd St",41.743116,-87.6148,20,23,0,0,20,23,43,43,0
"546",587,"Wabash Ave & 83rd St",41.743316,-87.622849,27,29,0,0,27,29,56,56,0
"547",588,"South Chicago Ave & 83rd St",41.743921,-87.575225,24,20,0,0,24,20,44,44,0
"548",589,"Milwaukee Ave & Cuyler Ave",41.954468,-87.749594,125,121,0,0,125,121,246,246,0
"549",590,"Kilbourn Ave & Irving Park Rd",41.953733,-87.740569,83,87,0,0,83,87,170,170,0
"550",591,"Kilbourn Ave & Milwaukee Ave",41.948818,-87.74002,71,80,0,0,71,80,151,151,0
"551",592,"Knox Ave & Montrose Ave",41.960631,-87.745359,73,68,0,0,73,68,141,141,0
"552",593,"Halsted St & 59th St",41.787539,-87.644874,7,7,0,0,7,7,14,14,0
"553",594,"Western Blvd & 48th Pl",41.805661,-87.683392,27,31,0,0,27,31,58,58,0
"554",595,"Wabash Ave & 87th St",41.736646,-87.622634,31,40,0,0,31,40,71,71,0
"555",596,"Benson Ave & Church St",42.048214,-87.683485,383,412,0,0,383,412,795,795,0
"556",597,"Chicago Ave & Washington St",42.032562,-87.679101,370,376,0,0,370,376,746,746,0
"557",598,"Elmwood Ave & Austin St",42.025784,-87.684107,77,78,0,0,77,78,155,155,0
"558",599,"Valli Produce - Evanston Plaza",42.039742,-87.699413,107,107,0,0,107,107,214,214,0
"559",600,"Dodge Ave & Church St",42.048308,-87.698224,106,102,0,0,106,102,208,208,0
"560",601,"Central St Metra",42.063598,-87.69873,165,162,0,0,165,162,327,327,0
"561",602,"Central St & Girard Ave",42.064313,-87.686152,175,192,0,0,175,192,367,367,0
"562",603,"Chicago Ave & Sheridan Rd",42.050491,-87.677821,405,417,0,0,405,417,822,822,0
"563",604,"Sheridan Rd & Noyes St (NU)",42.058239,-87.677432,252,269,0,0,252,269,521,521,0
"564",605,"University Library (NU)",42.052939,-87.673447,202,204,0,0,202,204,406,406,0
"565",619,"Keystone Ave & Fullerton Ave",41.92459,-87.72785,100,111,0,0,100,111,211,211,0
"566",620,"Orleans St & Chestnut St (NEXT Apts)",41.898203,-87.637536,646,610,0,0,646,610,1256,1256,0
"567",621,"Aberdeen St & Randolph St",41.884114,-87.654264,534,546,0,0,534,546,1080,1080,0
"568",622,"California Ave & Cortez St",41.900363,-87.696704,492,493,0,0,492,493,985,985,0
"569",623,"Michigan Ave & 8th St",41.872773,-87.623981,1185,1200,0,0,1185,1200,2385,2385,0
"570",624,"Dearborn St & Van Buren St",41.876268,-87.629155,556,526,0,0,556,526,1082,1082,0
"571",625,"Chicago Ave & Dempster St",42.041691,-87.680687,243,259,0,0,243,259,502,502,0
"572",626,"Delano Ct & Roosevelt Rd",41.867491,-87.63219,459,434,0,0,459,434,893,893,0
"573",627,"LaSalle Dr & Huron St",41.894877,-87.632326,690,625,0,0,690,625,1315,1315,0
"574",628,"Walsh Park",41.91461,-87.667968,334,319,0,0,334,319,653,653,0
"575",630,"Kildare Ave & Montrose Ave",41.96108,-87.73569,63,55,0,0,63,55,118,118,0
"576",631,"Malcolm X College",41.877618,-87.673895,103,103,0,0,103,103,206,206,0
"577",632,"Clark St & Newport St",41.94454,-87.654678,255,440,0,0,255,440,695,695,0
"578",635,"Fairbanks St & Superior St",41.895748,-87.620104,647,683,0,0,647,683,1330,1330,0
"579",636,"Orleans St & Hubbard St",41.890028,-87.636618,450,442,0,0,450,442,892,892,0
"580",637,"Wood St & Chicago Ave (*)",41.895634,-87.672069,29,200,0,0,29,200,229,229,0
"581",638,"Clinton St & Jackson Blvd",41.878116,-87.639838,325,294,0,0,325,294,619,619,0
"582",639,"Lakefront Trail & Wilson Ave",41.965845,-87.645361,903,906,0,0,903,906,1809,1809,0
"583",640,"Bernard St & Elston Ave",41.949923,-87.713949,12,30,0,0,12,30,42,42,0
"584",641,"Central Park Ave & Bloomingdale Ave",41.914166,-87.716755,93,138,0,0,93,138,231,231,0
"585",642,"Latrobe Ave & Chicago Ave",41.894745,-87.756895,27,21,0,0,27,21,48,48,0
"586",643,"Smith Park (*)",41.892048,-87.689397,15,121,0,0,15,121,136,136,0
"587",644,"Western Ave & Fillmore St (*)",41.868563,-87.686234,75,133,0,0,75,133,208,208,0
"588",645,"Archer (Damen) Ave & 37th St",41.826712,-87.683144,94,99,0,0,94,99,193,193,0
"589",646,"State St & 54th St",41.796642,-87.625923,11,13,0,0,11,13,24,24,0
"590",648,"Carpenter St & 63rd St",41.77987,-87.650919,1,3,0,0,1,3,4,4,0
"591",649,"Stewart Ave & 63rd St",41.779835,-87.634774,3,5,0,0,3,5,8,8,0
"592",650,"Eggleston Ave & 69th St",41.768898,-87.635876,4,10,0,0,4,10,14,14,0
"593",651,"Michigan Ave & 71st St",41.765286,-87.621748,1,1,0,0,1,1,2,2,0
"594",652,"Rhodes Ave & 71st St",41.766,-87.611726,7,3,0,0,7,3,10,10,0
"595",653,"Cornell Dr & Hayes Dr",41.780595,-87.584846,72,61,0,0,72,61,133,133,0
"596",654,"Racine Ave & Washington Blvd",41.883073,-87.656952,8,70,0,0,8,70,78,78,0
"597",655,"Hoyne Ave & Balmoral Ave",41.979851,-87.681932,23,54,0,0,23,54,77,77,0
"598",656,"Damen Ave & Walnut (Lake) St (*)",41.885951,-87.677009,1,98,0,0,1,98,99,99,0
"599",657,"Wood St & Augusta Blvd",41.899181,-87.6722,593,585,0,0,593,585,1178,1178,0
"600",658,"Leavitt St & Division St (*)",41.902997,-87.683825,16,160,0,0,16,160,176,176,0
"601",659,"Leavitt St & Chicago Ave",41.895501,-87.682017,495,481,0,0,495,481,976,976,0
"602",660,"Sheridan Rd & Columbia Ave",42.004583,-87.661406,369,374,0,0,369,374,743,743,0
"603",661,"Evanston Civic Center",42.057044,-87.686554,113,118,0,0,113,118,231,231,0
"604",662,"Dodge Ave & Mulford St",42.023463,-87.699595,82,79,0,0,82,79,161,161,0
"605",663,"Lincolnwood Dr & Central St",42.064854,-87.715297,82,85,0,0,82,85,167,167,0
"606",664,"Leavitt St & Belmont Ave",41.939354,-87.683282,54,166,0,0,54,166,220,220,0
"607",665,"South Chicago Ave & Elliot Ave",41.747363,-87.580046,3,2,0,0,3,2,5,5,0
"608",666,"Cherry Ave & Blackhawk St",41.907221,-87.655618,60,60,0,0,60,60,120,120,0
"609",671,"HUBBARD ST BIKE CHECKING (LBS-WH-TEST)",41.889954,-87.68065,151,186,0,0,151,186,337,337,0
"610",672,"Franklin St & Illinois St",41.891023,-87.635479,1028,1006,0,0,1028,1006,2034,2034,0
"611",673,"Lincoln Park Conservatory",41.923931,-87.635824,1350,1358,0,0,1350,1358,2708,2708,0
"612",674,"Michigan Ave & 71st St",41.765286,-87.621748,0,0,0,0,0,0,0,0,0
"613",0,"",0,0,0,0,0,0,0,0,0,0,0
