"","station_id","station_name","lat","long","start_n","end_n","e_start_n","e_end_n","c_start_n","c_end_n","total","classic","electric"
"1",2,"Buckingham Fountain",41.8765,-87.6205,269,250,0,0,269,250,519,519,0
"2",3,"Shedd Aquarium",41.8672,-87.6154,680,551,0,0,680,551,1231,1231,0
"3",4,"Burnham Harbor",41.8563,-87.6133,427,418,0,0,427,418,845,845,0
"4",5,"State St & Harrison St",41.8741,-87.6277,213,237,0,0,213,237,450,450,0
"5",6,"Dusable Harbor",41.887,-87.6128,532,428,0,0,532,428,960,960,0
"6",7,"Field Blvd & South Water St",41.8863,-87.6175,415,409,0,0,415,409,824,824,0
"7",9,"Leavitt St & Archer Ave",41.8288,-87.6806,26,25,0,0,26,25,51,51,0
"8",11,"Jeffery Blvd & 71st St",41.7666,-87.5764,16,20,0,0,16,20,36,36,0
"9",12,"South Shore Dr & 71st St",41.7664,-87.5657,45,44,0,0,45,44,89,89,0
"10",13,"Wilton Ave & Diversey Pkwy",41.9324,-87.6527,499,506,0,0,499,506,1005,1005,0
"11",14,"Morgan St & 18th St",41.8581,-87.6511,189,217,0,0,189,217,406,406,0
"12",15,"Racine Ave & 18th St",41.8582,-87.6565,213,198,0,0,213,198,411,411,0
"13",16,"Paulina Ave & North Ave",41.9103,-87.6701,224,231,0,0,224,231,455,455,0
"14",17,"Honore St & Division St",41.9031,-87.6739,312,305,0,0,312,305,617,617,0
"15",18,"Wacker Dr & Washington St",41.8831,-87.6373,504,472,0,0,504,472,976,976,0
"16",19,"Throop (Loomis) St & Taylor St",41.869,-87.6591,253,240,0,0,253,240,493,493,0
"17",20,"Sheffield Ave & Kingsbury St",41.9105,-87.6531,410,450,0,0,410,450,860,860,0
"18",21,"Aberdeen St & Jackson Blvd",41.8777,-87.6548,411,396,0,0,411,396,807,807,0
"19",22,"May St & Taylor St",41.8695,-87.6555,277,252,0,0,277,252,529,529,0
"20",23,"Orleans St & Elm St",41.9029,-87.6377,184,167,0,0,184,167,351,351,0
"21",24,"Fairbanks Ct & Grand Ave",41.8918,-87.6206,688,679,0,0,688,679,1367,1367,0
"22",25,"Michigan Ave & Pearson St",41.8977,-87.6235,303,321,0,0,303,321,624,624,0
"23",26,"McClurg Ct & Illinois St",41.8904,-87.6175,651,665,0,0,651,665,1316,1316,0
"24",27,"Larrabee St & North Ave",41.9102,-87.6435,134,143,0,0,134,143,277,277,0
"25",28,"Larrabee St & Menomonee St",41.9147,-87.6433,213,207,0,0,213,207,420,420,0
"26",29,"Noble St & Milwaukee Ave",41.9007,-87.6626,277,253,0,0,277,253,530,530,0
"27",30,"Ashland Ave & Augusta Blvd",41.8996,-87.6677,229,205,0,0,229,205,434,434,0
"28",31,"Franklin St & Chicago Ave",41.8967,-87.6357,537,533,0,0,537,533,1070,1070,0
"29",32,"Racine Ave & Congress Pkwy",41.8746,-87.657,241,223,0,0,241,223,464,464,0
"30",33,"State St & Van Buren St",41.8772,-87.6278,396,381,0,0,396,381,777,777,0
"31",34,"Cannon Dr & Fullerton Ave",41.9268,-87.6344,214,212,0,0,214,212,426,426,0
"32",35,"Streeter Dr & Grand Ave",41.8923,-87.612,1360,1495,0,0,1360,1495,2855,2855,0
"33",36,"Franklin St & Jackson Blvd",41.8777,-87.6353,874,831,0,0,874,831,1705,1705,0
"34",37,"Dearborn St & Adams St",41.8794,-87.6298,455,441,0,0,455,441,896,896,0
"35",38,"Clark St & Lake St",41.886,-87.6309,573,527,0,0,573,527,1100,1100,0
"36",39,"Wabash Ave & Adams St",41.8795,-87.6257,393,386,0,0,393,386,779,779,0
"37",40,"LaSalle St & Adams St",41.8793,-87.632,310,320,0,0,310,320,630,630,0
"38",41,"Federal St & Polk St",41.8721,-87.6295,532,512,0,0,532,512,1044,1044,0
"39",42,"Wabash Ave & Cermak Rd",41.8526,-87.6265,90,97,0,0,90,97,187,187,0
"40",43,"Michigan Ave & Washington St",41.884,-87.6247,896,1059,0,0,896,1059,1955,1955,0
"41",44,"State St & Randolph St",41.8847,-87.6277,643,631,0,0,643,631,1274,1274,0
"42",45,"Michigan Ave & Ida B Wells Dr",41.8762,-87.6244,227,189,0,0,227,189,416,416,0
"43",46,"Wells St & Walton St",41.8999,-87.6344,275,237,0,0,275,237,512,512,0
"44",47,"State St & Kinzie St",41.8892,-87.6278,649,715,0,0,649,715,1364,1364,0
"45",48,"Larrabee St & Kingsbury St",41.8978,-87.6429,851,790,0,0,851,790,1641,1641,0
"46",49,"Dearborn St & Monroe St",41.8813,-87.6295,821,845,0,0,821,845,1666,1666,0
"47",50,"Clark St & Ida B Wells Dr",41.8759,-87.6306,525,555,0,0,525,555,1080,1080,0
"48",51,"Clark St & Randolph St",41.8846,-87.6319,655,716,0,0,655,716,1371,1371,0
"49",52,"Michigan Ave & Lake St",41.886,-87.6241,807,815,0,0,807,815,1622,1622,0
"50",53,"Wells St & Huron St",41.8947,-87.6344,845,781,0,0,845,781,1626,1626,0
"51",54,"Ogden Ave & Chicago Ave",41.8964,-87.6541,368,398,0,0,368,398,766,766,0
"52",55,"Halsted St & Roosevelt Rd",41.8673,-87.6486,244,268,0,0,244,268,512,512,0
"53",56,"Desplaines St & Kinzie St",41.8887,-87.6444,967,893,0,0,967,893,1860,1860,0
"54",57,"Clinton St & Roosevelt Rd",41.8671,-87.6411,252,289,0,0,252,289,541,541,0
"55",58,"Marshfield Ave & Cortland St",41.916,-87.6689,524,491,0,0,524,491,1015,1015,0
"56",59,"Wabash Ave & Roosevelt Rd",41.8672,-87.626,843,918,0,0,843,918,1761,1761,0
"57",60,"Dayton St & North Ave",41.9106,-87.6494,328,349,0,0,328,349,677,677,0
"58",61,"Wood St & Milwaukee Ave",41.9077,-87.6726,422,412,0,0,422,412,834,834,0
"59",62,"McCormick Place",41.8514,-87.6188,82,55,0,0,82,55,137,137,0
"60",66,"Clinton St & Lake St",41.8856,-87.6418,891,932,0,0,891,932,1823,1823,0
"61",67,"Sheffield Ave & Fullerton Ave",41.9256,-87.6537,683,687,0,0,683,687,1370,1370,0
"62",68,"Clinton St & Tilden St",41.8759,-87.6408,278,289,0,0,278,289,567,567,0
"63",69,"Damen Ave & Pierce Ave",41.9094,-87.6777,680,748,0,0,680,748,1428,1428,0
"64",71,"Morgan St & Lake St",41.8855,-87.6523,762,748,0,0,762,748,1510,1510,0
"65",72,"Wabash Ave & 16th St",41.8604,-87.6258,317,338,0,0,317,338,655,655,0
"66",73,"Jefferson St & Monroe St",41.8804,-87.6427,360,333,0,0,360,333,693,693,0
"67",74,"Kingsbury St & Erie St",41.8938,-87.6417,774,634,0,0,774,634,1408,1408,0
"68",75,"Canal St & Jackson Blvd",41.8772,-87.6394,388,423,0,0,388,423,811,811,0
"69",76,"Lake Shore Dr & Monroe St",41.881,-87.6167,1275,1160,0,0,1275,1160,2435,2435,0
"70",77,"Clinton St & Madison St",41.8822,-87.6411,1579,1576,0,0,1579,1576,3155,3155,0
"71",80,"Aberdeen St & Monroe St",41.8804,-87.6555,441,396,0,0,441,396,837,837,0
"72",81,"Daley Center Plaza",41.8842,-87.6296,847,886,0,0,847,886,1733,1733,0
"73",84,"Milwaukee Ave & Grand Ave",41.8916,-87.6484,576,545,0,0,576,545,1121,1121,0
"74",85,"Michigan Ave & Oak St",41.901,-87.6238,885,978,0,0,885,978,1863,1863,0
"75",86,"Eckhart Park",41.8964,-87.661,285,263,0,0,285,263,548,548,0
"76",87,"Racine Ave & Fullerton Ave",41.9256,-87.6584,344,341,0,0,344,341,685,685,0
"77",88,"Racine Ave & Randolph St",41.8841,-87.6569,185,205,0,0,185,205,390,390,0
"78",89,"Financial Pl & Ida B Wells Dr",41.875,-87.6331,377,349,0,0,377,349,726,726,0
"79",90,"Millennium Park",41.881,-87.6241,865,1063,0,0,865,1063,1928,1928,0
"80",91,"Clinton St & Washington Blvd",41.8834,-87.6412,1458,1761,0,0,1458,1761,3219,3219,0
"81",92,"Carpenter St & Huron St",41.8946,-87.6534,313,245,0,0,313,245,558,558,0
"82",93,"Sheffield Ave & Willow St",41.9137,-87.6529,445,469,0,0,445,469,914,914,0
"83",94,"Clark St & Armitage Ave",41.9183,-87.6363,776,753,0,0,776,753,1529,1529,0
"84",95,"Stony Island Ave & 64th St",41.7789,-87.5866,5,4,0,0,5,4,9,9,0
"85",96,"Desplaines St & Randolph St",41.8846,-87.6446,433,380,0,0,433,380,813,813,0
"86",97,"Field Museum",41.8653,-87.6179,200,178,0,0,200,178,378,378,0
"87",98,"LaSalle St & Washington St",41.8827,-87.6325,449,436,0,0,449,436,885,885,0
"88",99,"Lake Shore Dr & Ohio St",41.8926,-87.6145,523,541,0,0,523,541,1064,1064,0
"89",100,"Orleans St & Merchandise Mart Plaza",41.8882,-87.6364,607,519,0,0,607,519,1126,1126,0
"90",101,"63rd St Beach",41.781,-87.5761,40,39,0,0,40,39,79,79,0
"91",102,"Stony Island Ave & 67th St",41.7735,-87.5853,14,19,0,0,14,19,33,33,0
"92",103,"Clinton St & Polk St",41.8715,-87.6409,47,57,0,0,47,57,104,104,0
"93",106,"State St & Pearson St",41.8974,-87.6287,381,353,0,0,381,353,734,734,0
"94",107,"Desplaines St & Jackson Blvd",41.8783,-87.6439,713,678,0,0,713,678,1391,1391,0
"95",108,"Halsted St & Polk St",41.8718,-87.6466,281,285,0,0,281,285,566,566,0
"96",109,"900 W Harrison St",41.8748,-87.6498,370,371,0,0,370,371,741,741,0
"97",110,"Dearborn St & Erie St",41.894,-87.6293,956,1029,0,0,956,1029,1985,1985,0
"98",111,"Sedgwick St & Huron St",41.8947,-87.6384,518,565,0,0,518,565,1083,1083,0
"99",112,"Green St & Randolph St",41.8837,-87.6487,414,441,0,0,414,441,855,855,0
"100",113,"Bissell St & Armitage Ave",41.9184,-87.6522,572,617,0,0,572,617,1189,1189,0
"101",114,"Sheffield Ave & Waveland Ave",41.9494,-87.6545,401,407,0,0,401,407,808,808,0
"102",115,"Sheffield Ave & Wellington Ave",41.9363,-87.6527,433,477,0,0,433,477,910,910,0
"103",116,"Western Ave & Winnebago Ave",41.9155,-87.687,355,380,0,0,355,380,735,735,0
"104",117,"Wilton Ave & Belmont Ave",41.9402,-87.653,642,661,0,0,642,661,1303,1303,0
"105",118,"Sedgwick St & North Ave",41.9114,-87.6387,525,496,0,0,525,496,1021,1021,0
"106",119,"Ashland Ave & Lake St",41.8859,-87.6672,238,195,0,0,238,195,433,433,0
"107",120,"Wentworth Ave & Cermak Rd (Temp)",41.853,-87.6306,88,134,0,0,88,134,222,222,0
"108",121,"Blackstone Ave & Hyde Park Blvd",41.8026,-87.5904,170,167,0,0,170,167,337,337,0
"109",122,"Ogden Ave & Congress Pkwy",41.875,-87.6733,58,50,0,0,58,50,108,108,0
"110",123,"California Ave & Milwaukee Ave",41.9227,-87.6972,320,288,0,0,320,288,608,608,0
"111",124,"Damen Ave & Cullerton St",41.855,-87.6757,85,92,0,0,85,92,177,177,0
"112",125,"Rush St & Hubbard St",41.8902,-87.6262,408,422,0,0,408,422,830,830,0
"113",126,"Clark St & North Ave",41.912,-87.6319,262,286,0,0,262,286,548,548,0
"114",127,"Lincoln Ave & Fullerton Ave",41.9259,-87.6493,599,618,0,0,599,618,1217,1217,0
"115",128,"Damen Ave & Chicago Ave",41.8958,-87.6772,371,422,0,0,371,422,793,793,0
"116",129,"Blue Island Ave & 18th St",41.8576,-87.6615,271,261,0,0,271,261,532,532,0
"117",130,"Damen Ave & Division St",41.9033,-87.6784,379,362,0,0,379,362,741,741,0
"118",131,"Lincoln Ave & Belmont Ave",41.9394,-87.6684,244,271,0,0,244,271,515,515,0
"119",132,"Wentworth Ave & 24th St (Temp)",41.8501,-87.6321,45,54,0,0,45,54,99,99,0
"120",133,"Kingsbury St & Kinzie St",41.8892,-87.6385,1160,1119,0,0,1160,1119,2279,2279,0
"121",134,"Peoria St & Jackson Blvd",41.8776,-87.6496,484,482,0,0,484,482,966,966,0
"122",135,"Halsted St & 21st St",41.8538,-87.6466,58,53,0,0,58,53,111,111,0
"123",136,"Racine Ave & 13th St",41.8651,-87.657,55,59,0,0,55,59,114,114,0
"124",137,"Morgan Ave & 14th Pl",41.8624,-87.6511,157,155,0,0,157,155,312,312,0
"125",138,"Clybourn Ave & Division St",41.9046,-87.6406,296,298,0,0,296,298,594,594,0
"126",140,"Dearborn Pkwy & Delaware Pl",41.899,-87.6299,650,641,0,0,650,641,1291,1291,0
"127",141,"Clark St & Lincoln Ave",41.9157,-87.6346,564,600,0,0,564,600,1164,1164,0
"128",142,"McClurg Ct & Erie St",41.8945,-87.6179,648,639,0,0,648,639,1287,1287,0
"129",143,"Sedgwick St & Webster Ave",41.9222,-87.6389,481,460,0,0,481,460,941,941,0
"130",144,"Larrabee St & Webster Ave",41.9218,-87.6441,578,564,0,0,578,564,1142,1142,0
"131",145,"Mies van der Rohe Way & Chestnut St",41.8986,-87.6219,424,407,0,0,424,407,831,831,0
"132",146,"Loomis St & Jackson Blvd",41.8779,-87.662,169,175,0,0,169,175,344,344,0
"133",147,"Indiana Ave & 26th St",41.8457,-87.6225,93,102,0,0,93,102,195,195,0
"134",148,"State St & 33rd St",41.8347,-87.6258,195,192,0,0,195,192,387,387,0
"135",149,"Calumet Ave & 33rd St",41.8349,-87.6179,115,103,0,0,115,103,218,218,0
"136",150,"Fort Dearborn Dr & 31st St",41.8386,-87.6082,226,212,0,0,226,212,438,438,0
"137",152,"Lincoln Ave & Diversey Pkwy",41.9322,-87.6586,280,270,0,0,280,270,550,550,0
"138",153,"Southport Ave & Wellington Ave",41.9357,-87.6636,351,386,0,0,351,386,737,737,0
"139",154,"Southport Ave & Belmont Ave",41.9395,-87.6638,225,230,0,0,225,230,455,455,0
"140",156,"Clark St & Wellington Ave",41.9365,-87.6475,468,471,0,0,468,471,939,939,0
"141",157,"Lake Shore Dr & Wellington Ave",41.9367,-87.6368,542,552,0,0,542,552,1094,1094,0
"142",158,"Milwaukee Ave & Wabansia Ave",41.9126,-87.6814,392,404,0,0,392,404,796,796,0
"143",159,"Claremont Ave & Hirsch St",41.9078,-87.6859,139,125,0,0,139,125,264,264,0
"144",160,"Campbell Ave & North Ave",41.9105,-87.6896,194,199,0,0,194,199,393,393,0
"145",161,"Rush St & Superior St",41.8958,-87.6259,594,586,0,0,594,586,1180,1180,0
"146",162,"Damen Ave & Wellington Ave",41.9359,-87.6784,144,131,0,0,144,131,275,275,0
"147",163,"Damen Ave & Clybourn Ave",41.9319,-87.6779,128,168,0,0,128,168,296,296,0
"148",164,"Franklin St & Lake St",41.8858,-87.6355,557,523,0,0,557,523,1080,1080,0
"149",165,"Clark St & Grace St",41.9508,-87.6592,329,301,0,0,329,301,630,630,0
"150",166,"Ashland Ave & Wrightwood Ave",41.9288,-87.6685,247,242,0,0,247,242,489,489,0
"151",167,"Damen Ave & Coulter St",41.8492,-87.6756,28,28,0,0,28,28,56,56,0
"152",168,"Michigan Ave & 14th St",41.8641,-87.6237,407,407,0,0,407,407,814,814,0
"153",169,"Canal St & Harrison St",41.8743,-87.6396,131,133,0,0,131,133,264,264,0
"154",170,"Clinton St & 18th St",41.858,-87.6408,103,114,0,0,103,114,217,217,0
"155",171,"May St & Cullerton St",41.8551,-87.6541,55,48,0,0,55,48,103,103,0
"156",172,"Rush St & Cedar St",41.9023,-87.6277,429,422,0,0,429,422,851,851,0
"157",173,"Mies van der Rohe Way & Chicago Ave",41.8969,-87.6217,502,500,0,0,502,500,1002,1002,0
"158",174,"Canal St & Madison St",41.8821,-87.6398,917,903,0,0,917,903,1820,1820,0
"159",175,"Wells St & Polk St",41.8726,-87.6335,410,328,0,0,410,328,738,738,0
"160",176,"Clark St & Elm St",41.903,-87.6313,1048,1138,0,0,1048,1138,2186,2186,0
"161",177,"Theater on the Lake",41.9263,-87.6308,961,1063,0,0,961,1063,2024,2024,0
"162",178,"State St & 19th St",41.8566,-87.6275,105,95,0,0,105,95,200,200,0
"163",179,"MLK Jr Dr & Pershing Rd",41.8246,-87.6168,47,48,0,0,47,48,95,95,0
"164",180,"Ritchie Ct & Banks St",41.9069,-87.6262,345,300,0,0,345,300,645,645,0
"165",181,"LaSalle St & Illinois St",41.8908,-87.6317,608,628,0,0,608,628,1236,1236,0
"166",182,"Wells St & Elm St",41.9032,-87.6343,640,586,0,0,640,586,1226,1226,0
"167",183,"Damen Ave & Thomas St (Augusta Blvd)",41.9013,-87.6774,212,191,0,0,212,191,403,403,0
"168",184,"State St & 35th St",41.8309,-87.628,104,102,0,0,104,102,206,206,0
"169",185,"Stave St & Armitage Ave",41.9177,-87.6914,99,104,0,0,99,104,203,203,0
"170",186,"Ogden Ave & Race Ave",41.8918,-87.6588,284,289,0,0,284,289,573,573,0
"171",188,"Greenview Ave & Fullerton Ave",41.9253,-87.6658,265,257,0,0,265,257,522,522,0
"172",190,"Southport Ave & Wrightwood Ave",41.9288,-87.6639,300,265,0,0,300,265,565,565,0
"173",191,"Canal St & Monroe St",41.8817,-87.6395,539,506,0,0,539,506,1045,1045,0
"174",192,"Canal St & Adams St",41.8793,-87.6399,1790,1966,0,0,1790,1966,3756,3756,0
"175",193,"State St & 29th St",41.8417,-87.6269,34,34,0,0,34,34,68,68,0
"176",194,"Wabash Ave & Wacker Pl",41.8869,-87.626,359,369,0,0,359,369,728,728,0
"177",195,"Columbus Dr & Randolph St",41.8847,-87.6195,1279,877,0,0,1279,877,2156,2156,0
"178",196,"Cityfront Plaza Dr & Pioneer Ct",41.8906,-87.6221,514,497,0,0,514,497,1011,1011,0
"179",197,"Michigan Ave & Madison St",41.8821,-87.6251,376,380,0,0,376,380,756,756,0
"180",198,"Green St & Madison St",41.8819,-87.6488,532,647,0,0,532,647,1179,1179,0
"181",199,"Wabash Ave & Grand Ave",41.8915,-87.6268,872,853,0,0,872,853,1725,1725,0
"182",200,"MLK Jr Dr & 47th St",41.8099,-87.6163,5,10,0,0,5,10,15,15,0
"183",201,"Indiana Ave & 40th St",41.8217,-87.6216,10,7,0,0,10,7,17,17,0
"184",202,"Halsted St & 18th St",41.8575,-87.6463,110,113,0,0,110,113,223,223,0
"185",203,"Western Ave & 21st St",41.8541,-87.6858,62,61,0,0,62,61,123,123,0
"186",204,"Prairie Ave & Garfield Blvd",41.7949,-87.6187,48,44,0,0,48,44,92,92,0
"187",205,"Paulina St & 18th St",41.8579,-87.6687,141,165,0,0,141,165,306,306,0
"188",206,"Halsted St & Archer Ave",41.8472,-87.6468,77,58,0,0,77,58,135,135,0
"189",207,"Emerald Ave & 28th St",41.8436,-87.6454,106,100,0,0,106,100,206,206,0
"190",208,"Laflin St & Cullerton St",41.8549,-87.6636,114,122,0,0,114,122,236,236,0
"191",209,"Normal Ave & Archer Ave",41.8495,-87.6406,52,49,0,0,52,49,101,101,0
"192",210,"Ashland Ave & Division St",41.9035,-87.6677,716,760,0,0,716,760,1476,1476,0
"193",211,"St. Clair St & Erie St",41.8944,-87.6227,997,1200,0,0,997,1200,2197,2197,0
"194",212,"Wells St & Hubbard St",41.8899,-87.6343,794,852,0,0,794,852,1646,1646,0
"195",213,"Leavitt St & North Ave",41.9102,-87.6823,203,203,0,0,203,203,406,406,0
"196",214,"Damen Ave & Grand Ave",41.8912,-87.6769,168,175,0,0,168,175,343,343,0
"197",215,"Damen Ave & Madison St",41.8814,-87.6749,101,86,0,0,101,86,187,187,0
"198",216,"California Ave & Division St",41.903,-87.6975,124,136,0,0,124,136,260,260,0
"199",217,"Elizabeth (May) St & Fulton St",41.8866,-87.658,184,205,0,0,184,205,389,389,0
"200",218,"Wells St & 19th St",41.8568,-87.6339,81,83,0,0,81,83,164,164,0
"201",219,"Damen Ave & Cortland St",41.916,-87.6773,401,392,0,0,401,392,793,793,0
"202",220,"Clark St & Drummond Pl",41.9312,-87.6443,543,558,0,0,543,558,1101,1101,0
"203",222,"Milwaukee Ave & Rockwell St",41.9202,-87.693,153,168,0,0,153,168,321,321,0
"204",223,"Clifton Ave & Armitage Ave",41.9182,-87.6569,338,303,0,0,338,303,641,641,0
"205",224,"Halsted St & Willow St",41.9139,-87.6488,278,307,0,0,278,307,585,585,0
"206",225,"Halsted St & Dickens Ave",41.9199,-87.6488,433,443,0,0,433,443,876,876,0
"207",226,"Racine Ave & Belmont Ave",41.9397,-87.6589,244,250,0,0,244,250,494,494,0
"208",227,"Southport Ave & Waveland Ave",41.9482,-87.6639,472,488,0,0,472,488,960,960,0
"209",228,"Damen Ave & Melrose Ave",41.9406,-87.6785,114,86,0,0,114,86,200,200,0
"210",229,"Southport Ave & Roscoe St",41.9437,-87.664,455,460,0,0,455,460,915,915,0
"211",230,"Lincoln Ave & Roscoe St",41.9433,-87.671,292,298,0,0,292,298,590,590,0
"212",231,"Sheridan Rd & Montrose Ave",41.9617,-87.6546,340,343,0,0,340,343,683,683,0
"213",232,"Pine Grove Ave & Waveland Ave",41.9493,-87.6463,525,529,0,0,525,529,1054,1054,0
"214",233,"Sangamon St & Washington Blvd",41.8832,-87.6511,294,272,0,0,294,272,566,566,0
"215",234,"Clark St & Montrose Ave",41.9616,-87.666,203,193,0,0,203,193,396,396,0
"216",236,"Sedgwick St & Schiller St",41.9076,-87.6386,145,144,0,0,145,144,289,289,0
"217",237,"MLK Jr Dr & 29th St",41.8421,-87.617,175,144,0,0,175,144,319,319,0
"218",238,"Wolcott (Ravenswood) Ave & Montrose Ave",41.9614,-87.6762,156,151,0,0,156,151,307,307,0
"219",239,"Western Ave & Leland Ave",41.9665,-87.6884,211,215,0,0,211,215,426,426,0
"220",240,"Sheridan Rd & Irving Park Rd",41.9542,-87.6544,472,458,0,0,472,458,930,930,0
"221",241,"Morgan St & Polk St",41.8717,-87.651,479,464,0,0,479,464,943,943,0
"222",242,"Damen Ave & Leland Ave",41.9671,-87.679,244,240,0,0,244,240,484,484,0
"223",243,"Lincoln Ave & Sunnyside Ave",41.963,-87.6848,153,147,0,0,153,147,300,300,0
"224",244,"Ravenswood Ave & Irving Park Rd",41.9547,-87.6739,149,174,0,0,149,174,323,323,0
"225",245,"Clarendon Ave & Junior Ter",41.961,-87.6496,206,207,0,0,206,207,413,413,0
"226",246,"Ashland Ave & Belle Plaine Ave",41.9561,-87.6688,92,82,0,0,92,82,174,174,0
"227",247,"Shore Dr & 55th St",41.7952,-87.5807,327,333,0,0,327,333,660,660,0
"228",248,"Woodlawn Ave & 55th St",41.7953,-87.5965,225,219,0,0,225,219,444,444,0
"229",249,"Montrose Harbor",41.964,-87.6382,385,366,0,0,385,366,751,751,0
"230",250,"Ashland Ave & Wellington Ave",41.9361,-87.6698,175,169,0,0,175,169,344,344,0
"231",251,"Clarendon Ave & Leland Ave",41.968,-87.65,136,150,0,0,136,150,286,286,0
"232",252,"Greenwood Ave & 47th St",41.8098,-87.5994,42,33,0,0,42,33,75,75,0
"233",253,"Winthrop Ave & Lawrence Ave",41.9688,-87.6577,130,139,0,0,130,139,269,269,0
"234",254,"Pine Grove Ave & Irving Park Rd",41.9544,-87.648,452,406,0,0,452,406,858,858,0
"235",255,"Indiana Ave & Roosevelt Rd",41.8679,-87.623,890,877,0,0,890,877,1767,1767,0
"236",256,"Broadway & Sheridan Rd",41.9528,-87.65,336,293,0,0,336,293,629,629,0
"237",257,"Lincoln Ave & Waveland Ave",41.9488,-87.6753,197,202,0,0,197,202,399,399,0
"238",258,"Logan Blvd & Elston Ave",41.9295,-87.6842,179,214,0,0,179,214,393,393,0
"239",259,"California Ave & Francis Pl (Temp)",41.9185,-87.6974,98,105,0,0,98,105,203,203,0
"240",260,"Kedzie Ave & Milwaukee Ave",41.9296,-87.7079,309,346,0,0,309,346,655,655,0
"241",261,"Hermitage Ave & Polk St",41.8715,-87.6699,186,204,0,0,186,204,390,390,0
"242",262,"Halsted St & 37th St",41.8271,-87.6457,19,22,0,0,19,22,41,41,0
"243",263,"Rhodes Ave & 32nd St",41.8362,-87.6135,70,61,0,0,70,61,131,131,0
"244",264,"Stetson Ave & South Water St",41.8868,-87.6223,429,319,0,0,429,319,748,748,0
"245",265,"Cottage Grove Ave & Oakwood Blvd",41.823,-87.6071,41,39,0,0,41,39,80,80,0
"246",267,"Lake Park Ave & 47th St",41.8094,-87.5919,71,105,0,0,71,105,176,176,0
"247",268,"Lake Shore Dr & North Blvd",41.9117,-87.6268,764,756,0,0,764,756,1520,1520,0
"248",270,"Stony Island Ave & 75th St",41.7587,-87.5869,9,9,0,0,9,9,18,18,0
"249",271,"Cottage Grove Ave & 43rd St",41.8165,-87.6066,33,33,0,0,33,33,66,66,0
"250",272,"Indiana Ave & 31st St",41.8388,-87.6219,92,87,0,0,92,87,179,179,0
"251",273,"Michigan Ave & 18th St",41.8578,-87.6246,418,396,0,0,418,396,814,814,0
"252",274,"Racine Ave & 15th St",41.8613,-87.6566,55,55,0,0,55,55,110,110,0
"253",275,"Ashland Ave & 13th St",41.8652,-87.6665,102,131,0,0,102,131,233,233,0
"254",276,"California Ave & North Ave",41.9104,-87.6972,124,131,0,0,124,131,255,255,0
"255",277,"Ashland Ave & Grand Ave",41.8911,-87.6666,190,178,0,0,190,178,368,368,0
"256",278,"Wallace St & 35th St",41.8306,-87.6413,39,48,0,0,39,48,87,87,0
"257",279,"Halsted St & 35th St",41.8307,-87.6472,36,43,0,0,36,43,79,79,0
"258",280,"Morgan St & 31st St",41.8378,-87.6511,72,73,0,0,72,73,145,145,0
"259",281,"Western Ave & 24th St",41.8485,-87.6851,25,18,0,0,25,18,43,43,0
"260",282,"Halsted St & Maxwell St",41.8649,-87.6471,228,252,0,0,228,252,480,480,0
"261",283,"LaSalle St & Jackson Blvd",41.8782,-87.6319,784,785,0,0,784,785,1569,1569,0
"262",284,"Michigan Ave & Jackson Blvd",41.8779,-87.6241,423,453,0,0,423,453,876,876,0
"263",285,"Wood St & Hubbard St",41.8899,-87.6715,122,143,0,0,122,143,265,265,0
"264",286,"Franklin St & Adams St (Temp)",41.8794,-87.6355,390,378,0,0,390,378,768,768,0
"265",287,"Franklin St & Monroe St",41.8803,-87.6352,1002,1053,0,0,1002,1053,2055,2055,0
"266",288,"Larrabee St & Armitage Ave",41.9181,-87.6437,283,264,0,0,283,264,547,547,0
"267",289,"Wells St & Concord Ln",41.9121,-87.6347,909,874,0,0,909,874,1783,1783,0
"268",290,"Kedzie Ave & Palmer Ct",41.9215,-87.7073,140,126,0,0,140,126,266,266,0
"269",291,"Wells St & Evergreen Ave",41.9067,-87.6348,587,519,0,0,587,519,1106,1106,0
"270",292,"Southport Ave & Clark St",41.9571,-87.6642,125,118,0,0,125,118,243,243,0
"271",293,"Broadway & Wilson Ave",41.9652,-87.6581,269,311,0,0,269,311,580,580,0
"272",294,"Broadway & Berwyn Ave",41.9784,-87.6598,237,256,0,0,237,256,493,493,0
"273",295,"Broadway & Argyle St",41.9738,-87.6597,223,237,0,0,223,237,460,460,0
"274",296,"Broadway & Belmont Ave",41.9401,-87.6455,390,409,0,0,390,409,799,799,0
"275",297,"Paulina St & Montrose Ave",41.9615,-87.6714,85,86,0,0,85,86,171,171,0
"276",298,"Lincoln Ave & Belle Plaine Ave",41.956,-87.6803,127,145,0,0,127,145,272,272,0
"277",299,"Halsted St & Roscoe St",41.9437,-87.649,400,411,0,0,400,411,811,811,0
"278",300,"Broadway & Barry Ave",41.9377,-87.6441,759,821,0,0,759,821,1580,1580,0
"279",301,"Clark St & Schiller St",41.908,-87.6315,570,490,0,0,570,490,1060,1060,0
"280",302,"Sheffield Ave & Wrightwood Ave",41.9287,-87.6538,294,259,0,0,294,259,553,553,0
"281",303,"Broadway & Cornelia Ave",41.9455,-87.6464,500,468,0,0,500,468,968,968,0
"282",304,"Broadway & Waveland Ave",41.9491,-87.6486,511,515,0,0,511,515,1026,1026,0
"283",305,"Western Ave & Division St",41.9029,-87.6873,166,165,0,0,166,165,331,331,0
"284",306,"Sheridan Rd & Buena Ave",41.9585,-87.655,217,198,0,0,217,198,415,415,0
"285",307,"Southport Ave & Clybourn Ave",41.9208,-87.6637,252,274,0,0,252,274,526,526,0
"286",308,"Seeley Ave & Roscoe St",41.9434,-87.6796,146,152,0,0,146,152,298,298,0
"287",309,"Leavitt St & Armitage Ave",41.9178,-87.6824,164,144,0,0,164,144,308,308,0
"288",310,"Damen Ave & Charleston St",41.9201,-87.6779,162,153,0,0,162,153,315,315,0
"289",311,"Leavitt St & Lawrence Ave",41.9689,-87.684,100,90,0,0,100,90,190,190,0
"290",312,"Clarendon Ave & Gordon Ter",41.9579,-87.6495,367,360,0,0,367,360,727,727,0
"291",313,"Lakeview Ave & Fullerton Pkwy",41.9259,-87.639,528,511,0,0,528,511,1039,1039,0
"292",314,"Ravenswood Ave & Berteau Ave",41.9579,-87.6736,84,93,0,0,84,93,177,177,0
"293",315,"Elston Ave & Wabansia Ave",41.9129,-87.6642,98,101,0,0,98,101,199,199,0
"294",316,"Damen Ave & Sunnyside Ave",41.9633,-87.6793,86,83,0,0,86,83,169,169,0
"295",317,"Wood St & Taylor St",41.8692,-87.671,258,274,0,0,258,274,532,532,0
"296",318,"Southport Ave & Irving Park Rd",41.9542,-87.6644,195,166,0,0,195,166,361,361,0
"297",319,"Greenview Ave & Diversey Pkwy",41.9326,-87.6659,155,151,0,0,155,151,306,306,0
"298",320,"Loomis St & Lexington St",41.8722,-87.6615,646,552,0,0,646,552,1198,1198,0
"299",321,"Wabash Ave & 9th St",41.8708,-87.6257,549,525,0,0,549,525,1074,1074,0
"300",322,"Kimbark Ave & 53rd St",41.7996,-87.5947,391,450,0,0,391,450,841,841,0
"301",323,"Sheridan Rd & Lawrence Ave",41.9695,-87.6547,125,125,0,0,125,125,250,250,0
"302",324,"Stockton Dr & Wrightwood Ave",41.9313,-87.6387,478,472,0,0,478,472,950,950,0
"303",325,"Clark St & Winnemac Ave",41.9733,-87.6678,357,350,0,0,357,350,707,707,0
"304",326,"Clark St & Leland Ave",41.9671,-87.6674,200,231,0,0,200,231,431,431,0
"305",327,"Sheffield Ave & Webster Ave",41.9215,-87.6538,173,159,0,0,173,159,332,332,0
"306",328,"Ellis Ave & 58th St",41.7887,-87.6013,229,216,0,0,229,216,445,445,0
"307",329,"Lake Shore Dr & Diversey Pkwy",41.9326,-87.6364,418,393,0,0,418,393,811,811,0
"308",330,"Lincoln Ave & Addison St",41.9462,-87.6733,91,95,0,0,91,95,186,186,0
"309",331,"Halsted St & Clybourn Ave",41.9097,-87.6481,578,585,0,0,578,585,1163,1163,0
"310",332,"Burling St (Halsted) & Diversey Pkwy (Temp)",41.9331,-87.6478,441,480,0,0,441,480,921,921,0
"311",333,"Ashland Ave & Blackhawk St",41.9071,-87.6673,297,318,0,0,297,318,615,615,0
"312",334,"Lake Shore Dr & Belmont Ave",41.9408,-87.6392,569,611,0,0,569,611,1180,1180,0
"313",335,"Calumet Ave & 35th St",41.8314,-87.618,43,56,0,0,43,56,99,99,0
"314",336,"Cottage Grove Ave & 47th St",41.8099,-87.6068,49,42,0,0,49,42,91,91,0
"315",337,"Clark St & Chicago Ave",41.8968,-87.6309,520,481,0,0,520,481,1001,1001,0
"316",338,"Calumet Ave & 18th St",41.8576,-87.6194,273,316,0,0,273,316,589,589,0
"317",339,"Emerald Ave & 31st St",41.8382,-87.6451,124,145,0,0,124,145,269,269,0
"318",340,"Clark St & Wrightwood Ave",41.9295,-87.6431,567,558,0,0,567,558,1125,1125,0
"319",341,"Adler Planetarium",41.8661,-87.6073,441,392,0,0,441,392,833,833,0
"320",342,"Wolcott Ave & Polk St",41.8713,-87.6737,508,482,0,0,508,482,990,990,0
"321",343,"Racine Ave & Wrightwood Ave",41.9289,-87.659,165,145,0,0,165,145,310,310,0
"322",344,"Ravenswood Ave & Lawrence Ave",41.9691,-87.6742,539,590,0,0,539,590,1129,1129,0
"323",345,"Lake Park Ave & 56th St",41.7932,-87.5878,255,256,0,0,255,256,511,511,0
"324",346,"Ada St & Washington Blvd",41.8828,-87.6612,262,269,0,0,262,269,531,531,0
"325",347,"Ashland Ave & Grace St",41.9507,-87.6687,157,173,0,0,157,173,330,330,0
"326",348,"California Ave & 21st St",41.8538,-87.6957,29,46,0,0,29,46,75,75,0
"327",349,"Halsted St & Wrightwood Ave",41.9291,-87.6491,377,373,0,0,377,373,750,750,0
"328",350,"Ashland Ave & Chicago Ave",41.896,-87.6677,189,200,0,0,189,200,389,389,0
"329",351,"Cottage Grove Ave & 51st St",41.803,-87.6066,58,48,0,0,58,48,106,106,0
"330",352,"Jeffery Blvd & 67th St",41.7735,-87.5771,7,10,0,0,7,10,17,17,0
"331",353,"Clark St & Touhy Ave",42.0126,-87.6744,25,28,0,0,25,28,53,53,0
"332",354,"Sheridan Rd & Greenleaf Ave",42.0106,-87.6624,84,82,0,0,84,82,166,166,0
"333",355,"South Shore Dr & 67th St",41.7736,-87.5675,26,26,0,0,26,26,52,52,0
"334",356,"Stony Island Ave & 71st St",41.7665,-87.5865,13,10,0,0,13,10,23,23,0
"335",359,"Larrabee St & Division St",41.9035,-87.6434,500,474,0,0,500,474,974,974,0
"336",364,"Larrabee St & Oak St",41.9002,-87.643,326,336,0,0,326,336,662,662,0
"337",365,"Halsted St & North Branch St",41.8994,-87.6485,80,79,0,0,80,79,159,159,0
"338",366,"Loomis St & Archer Ave",41.8416,-87.6574,49,46,0,0,49,46,95,95,0
"339",367,"Racine Ave & 35th St",41.8307,-87.656,23,28,0,0,23,28,51,51,0
"340",368,"Ashland Ave & Archer Ave",41.8392,-87.6656,32,24,0,0,32,24,56,56,0
"341",369,"Wood St & 35th St",41.8301,-87.6703,17,13,0,0,17,13,30,30,0
"342",370,"Calumet Ave & 21st St",41.8542,-87.6192,89,83,0,0,89,83,172,172,0
"343",373,"Kedzie Ave & Chicago Ave",41.8955,-87.7061,39,35,0,0,39,35,74,74,0
"344",374,"Western Ave & Walton St",41.8984,-87.6866,260,247,0,0,260,247,507,507,0
"345",375,"Sacramento Blvd & Franklin Blvd",41.8905,-87.7026,14,24,0,0,14,24,38,38,0
"346",376,"Artesian Ave & Hubbard St",41.8895,-87.6882,251,169,0,0,251,169,420,420,0
"347",377,"Kedzie Ave & Lake St",41.8846,-87.7063,49,45,0,0,49,45,94,94,0
"348",378,"California Ave & Lake St",41.8845,-87.6963,28,26,0,0,28,26,54,54,0
"349",381,"Western Ave & Monroe St",41.8798,-87.6861,68,88,0,0,68,88,156,156,0
"350",382,"Western Ave & Congress Pkwy",41.8747,-87.6864,63,61,0,0,63,61,124,124,0
"351",383,"Paulina St & Flournoy St",41.873,-87.6691,170,150,0,0,170,150,320,320,0
"352",384,"Halsted St & 51st St",41.8018,-87.6452,3,0,0,0,3,0,0,0,0
"353",385,"Princeton Ave & Garfield Blvd",41.795,-87.6331,18,14,0,0,18,14,32,32,0
"354",386,"Halsted St & 56th St",41.7929,-87.645,1,4,0,0,1,4,5,5,0
"355",388,"Halsted St & 63rd St",41.7794,-87.6446,10,14,0,0,10,14,24,24,0
"356",390,"Wentworth Ave & 63rd St",41.7801,-87.6297,14,7,0,0,14,7,21,21,0
"357",391,"Halsted St & 69th St",41.7691,-87.6446,1,2,0,0,1,2,3,3,0
"358",392,"Perry Ave & 69th St",41.7693,-87.6282,1,3,0,0,1,3,4,4,0
"359",393,"Calumet Ave & 71st St",41.7655,-87.6169,3,0,0,0,3,0,0,0,0
"360",394,"Clark St & 9th St (AMLI)",41.8708,-87.6312,220,198,0,0,220,198,418,418,0
"361",395,"Jeffery Blvd & 76th St",41.7571,-87.5758,2,1,0,0,2,1,3,3,0
"362",396,"Yates Blvd & 75th St",41.7588,-87.5664,3,3,0,0,3,3,6,6,0
"363",398,"Rainbow Beach",41.7579,-87.5494,3,2,0,0,3,2,5,5,0
"364",399,"South Shore Dr & 74th St",41.7622,-87.5593,6,3,0,0,6,3,9,9,0
"365",400,"Cottage Grove Ave & 71st St",41.7657,-87.605,0,0,0,0,0,0,0,0,0
"366",401,"Shields Ave & 28th Pl",41.8427,-87.6355,60,46,0,0,60,46,106,106,0
"367",402,"Shields Ave & 31st St",41.8385,-87.6354,63,61,0,0,63,61,124,124,0
"368",403,"Wentworth Ave & 33rd St",41.8345,-87.6318,30,36,0,0,30,36,66,66,0
"369",405,"Wentworth Ave & 35th St",41.8308,-87.6325,43,38,0,0,43,38,81,81,0
"370",406,"Lake Park Ave & 35th St",41.8313,-87.6088,116,111,0,0,116,111,227,227,0
"371",407,"State St & Pershing Rd",41.823,-87.6266,8,6,0,0,8,6,14,14,0
"372",408,"Union Ave & Root St",41.8191,-87.6433,6,7,0,0,6,7,13,13,0
"373",410,"Prairie Ave & 43rd St",41.8167,-87.6194,37,34,0,0,37,34,71,71,0
"374",411,"Halsted St & 47th Pl",41.8081,-87.6456,9,8,0,0,9,8,17,17,0
"375",412,"Princeton Ave & 47th St",41.8093,-87.6334,9,5,0,0,9,5,14,14,0
"376",413,"Woodlawn Ave & Lake Park Ave",41.8141,-87.597,80,79,0,0,80,79,159,159,0
"377",414,"Canal St & Taylor St",41.8703,-87.6395,266,285,0,0,266,285,551,551,0
"378",415,"Calumet Ave & 51st St",41.8023,-87.6181,14,20,0,0,14,20,34,34,0
"379",416,"Dorchester Ave & 49th St",41.8058,-87.5925,41,33,0,0,41,33,74,74,0
"380",417,"Cornell Ave & Hyde Park Blvd",41.8024,-87.5869,295,283,0,0,295,283,578,578,0
"381",418,"Ellis Ave & 53rd St",41.7993,-87.601,250,243,0,0,250,243,493,493,0
"382",419,"Lake Park Ave & 53rd St",41.7995,-87.5865,166,170,0,0,166,170,336,336,0
"383",420,"Ellis Ave & 55th St",41.7943,-87.6015,393,394,0,0,393,394,787,787,0
"384",421,"MLK Jr Dr & 56th St",41.7934,-87.6159,5,2,0,0,5,2,7,7,0
"385",422,"DuSable Museum",41.7916,-87.6079,22,21,0,0,22,21,43,43,0
"386",423,"University Ave & 57th St",41.7915,-87.5999,627,627,0,0,627,627,1254,1254,0
"387",424,"Museum of Science and Industry",41.7917,-87.5839,106,114,0,0,106,114,220,220,0
"388",425,"Harper Ave & 59th St",41.7879,-87.5883,159,151,0,0,159,151,310,310,0
"389",426,"Ellis Ave & 60th St",41.7851,-87.6011,396,381,0,0,396,381,777,777,0
"390",427,"Cottage Grove Ave & 63rd St",41.7806,-87.6061,17,15,0,0,17,15,32,32,0
"391",428,"Dorchester Ave & 63rd St",41.7804,-87.5914,14,22,0,0,14,22,36,36,0
"392",429,"Cottage Grove Ave & 67th St",41.7737,-87.6056,12,12,0,0,12,12,24,24,0
"393",430,"MLK Jr Dr & 63rd St",41.7801,-87.6159,9,14,0,0,9,14,23,23,0
"394",431,"Eberhart Ave & 61st St",41.7841,-87.6133,7,7,0,0,7,7,14,14,0
"395",432,"Clark St & Lunt Ave",42.0091,-87.6742,99,111,0,0,99,111,210,210,0
"396",433,"Kedzie Ave & Harrison St",41.8736,-87.7049,9,8,0,0,9,8,17,17,0
"397",434,"Ogden Ave & Roosevelt Rd",41.8665,-87.6847,49,45,0,0,49,45,94,94,0
"398",435,"Kedzie Ave & Roosevelt Rd",41.8665,-87.7065,10,10,0,0,10,10,20,20,0
"399",436,"Fairfield Ave & Roosevelt Rd",41.8666,-87.6945,8,7,0,0,8,7,15,15,0
"400",437,"Washtenaw Ave & Ogden Ave",41.8619,-87.6935,50,52,0,0,50,52,102,102,0
"401",438,"Central Park Ave & Ogden Ave",41.8542,-87.7154,13,10,0,0,13,10,23,23,0
"402",439,"Kedzie Ave & 21st St",41.8535,-87.7051,18,15,0,0,18,15,33,33,0
"403",440,"Central Park Ave & 24th St",41.8481,-87.7151,4,3,0,0,4,3,7,7,0
"404",441,"Kedzie Ave & 24th St",41.8482,-87.7054,6,4,0,0,6,4,10,10,0
"405",442,"California Ave & 23rd Pl",41.8491,-87.6951,59,56,0,0,59,56,115,115,0
"406",443,"Millard Ave & 26th St",41.8446,-87.7159,6,4,0,0,6,4,10,10,0
"407",444,"Albany Ave & 26th St",41.8445,-87.702,4,3,0,0,4,3,7,7,0
"408",445,"California Ave & 26th St",41.844,-87.6953,2,2,0,0,2,2,4,4,0
"409",446,"Western Ave & 28th St",41.8415,-87.6851,13,11,0,0,13,11,24,24,0
"410",447,"Glenwood Ave & Morse Ave",42.008,-87.6655,91,108,0,0,91,108,199,199,0
"411",448,"Warren Park East",42.0046,-87.6807,60,52,0,0,60,52,112,112,0
"412",449,"Clark St & Columbia Ave",42.0045,-87.6724,54,62,0,0,54,62,116,116,0
"413",450,"Warren Park West",42.0018,-87.6888,54,51,0,0,54,51,105,105,0
"414",451,"Sheridan Rd & Loyola Ave",42.001,-87.6612,131,153,0,0,131,153,284,284,0
"415",452,"Western Ave & Granville Ave",41.9942,-87.6894,75,81,0,0,75,81,156,156,0
"416",453,"Clark St & Schreiber Ave",41.9993,-87.6714,81,75,0,0,81,75,156,156,0
"417",454,"Broadway & Granville Ave",41.9948,-87.6603,208,209,0,0,208,209,417,417,0
"418",455,"Maplewood Ave & Peterson Ave",41.9902,-87.6934,8,11,0,0,8,11,19,19,0
"419",456,"2112 W Peterson Ave",41.9912,-87.6836,23,31,0,0,23,31,54,54,0
"420",457,"Clark St & Elmdale Ave",41.9905,-87.6698,87,80,0,0,87,80,167,167,0
"421",458,"Broadway & Thorndale Ave",41.9897,-87.6601,161,175,0,0,161,175,336,336,0
"422",459,"Lakefront Trail & Bryn Mawr Ave",41.984,-87.6523,356,415,0,0,356,415,771,771,0
"423",460,"Clark St & Bryn Mawr Ave",41.9836,-87.6692,172,199,0,0,172,199,371,371,0
"424",461,"Broadway & Ridge Ave",41.984,-87.6603,202,177,0,0,202,177,379,379,0
"425",462,"Winchester (Ravenswood) Ave & Balmoral Ave",41.9798,-87.6775,85,85,0,0,85,85,170,170,0
"426",463,"Clark St & Berwyn Ave",41.978,-87.668,236,263,0,0,236,263,499,499,0
"427",464,"Damen Ave & Foster Ave",41.9756,-87.6795,160,153,0,0,160,153,313,313,0
"428",465,"Marine Dr & Ainslie St",41.9716,-87.6502,188,184,0,0,188,184,372,372,0
"429",466,"Ridge Blvd & Touhy Ave",42.0121,-87.6829,22,17,0,0,22,17,39,39,0
"430",467,"Western Ave & Lunt Ave",42.0086,-87.6905,89,76,0,0,89,76,165,165,0
"431",468,"Budlong Woods Library",41.9837,-87.6964,17,18,0,0,17,18,35,35,0
"432",469,"St. Louis Ave & Balmoral Ave",41.9804,-87.7161,29,23,0,0,29,23,52,52,0
"433",470,"Kedzie Ave & Foster Ave",41.9757,-87.7093,36,30,0,0,36,30,66,66,0
"434",471,"Francisco Ave & Foster Ave",41.9756,-87.7014,64,68,0,0,64,68,132,132,0
"435",472,"Lincoln Ave & Winona St",41.9749,-87.6925,47,56,0,0,47,56,103,103,0
"436",474,"Christiana Ave & Lawrence Ave",41.9684,-87.7118,39,43,0,0,39,43,82,82,0
"437",475,"Washtenaw Ave & Lawrence Ave",41.969,-87.696,93,90,0,0,93,90,183,183,0
"438",476,"Kedzie Ave & Leland Ave",41.9667,-87.7081,72,78,0,0,72,78,150,150,0
"439",477,"Manor Ave & Leland Ave",41.9659,-87.7008,59,66,0,0,59,66,125,125,0
"440",478,"Rockwell St & Eastwood Ave",41.9659,-87.6936,104,105,0,0,104,105,209,209,0
"441",479,"Drake Ave & Montrose Ave",41.9612,-87.7166,26,33,0,0,26,33,59,59,0
"442",480,"Albany Ave & Montrose Ave",41.961,-87.7059,52,48,0,0,52,48,100,100,0
"443",481,"California Ave & Montrose Ave",41.9611,-87.6954,159,148,0,0,159,148,307,307,0
"444",482,"Campbell Ave & Montrose Ave",41.9615,-87.6912,89,95,0,0,89,95,184,184,0
"445",483,"Avondale Ave & Irving Park Rd",41.9534,-87.732,58,53,0,0,58,53,111,111,0
"446",484,"Monticello Ave & Irving Park Rd",41.954,-87.7191,43,40,0,0,43,40,83,83,0
"447",485,"Sawyer Ave & Irving Park Rd",41.9536,-87.7093,29,29,0,0,29,29,58,58,0
"448",486,"Oakley Ave & Irving Park Rd",41.9543,-87.6861,67,83,0,0,67,83,150,150,0
"449",487,"California Ave & Byron St",41.9522,-87.6981,44,45,0,0,44,45,89,89,0
"450",488,"Pulaski Rd & Eddy St (Temp)",41.9463,-87.731,22,21,0,0,22,21,43,43,0
"451",489,"Drake Ave & Addison St",41.9473,-87.7176,67,64,0,0,67,64,131,131,0
"452",490,"Troy St & Elston Ave",41.9452,-87.7067,66,66,0,0,66,66,132,132,0
"453",491,"Talman Ave & Addison St",41.9466,-87.6946,91,98,0,0,91,98,189,189,0
"454",492,"Leavitt St & Addison St",41.9467,-87.6834,44,47,0,0,44,47,91,91,0
"455",493,"Western Ave & Roscoe St",41.943,-87.6873,122,120,0,0,122,120,242,242,0
"456",494,"Kedzie Ave & Bryn Mawr Ave",41.9824,-87.7089,22,29,0,0,22,29,51,51,0
"457",495,"Keystone Ave & Montrose Ave",41.9611,-87.729,20,17,0,0,20,17,37,37,0
"458",496,"Avers Ave & Belmont Ave",41.9394,-87.7236,37,36,0,0,37,36,73,73,0
"459",497,"Kimball Ave & Belmont Ave",41.9394,-87.7116,66,56,0,0,66,56,122,122,0
"460",498,"California Ave & Fletcher St",41.9384,-87.698,69,85,0,0,69,85,154,154,0
"461",499,"Kosciuszko Park",41.9306,-87.7238,107,116,0,0,107,116,223,223,0
"462",500,"Central Park Ave & Elbridge Ave",41.9353,-87.7169,76,74,0,0,76,74,150,150,0
"463",501,"Richmond St & Diversey Ave",41.9319,-87.7012,103,90,0,0,103,90,193,193,0
"464",502,"California Ave & Altgeld St",41.9267,-87.6977,102,111,0,0,102,111,213,213,0
"465",503,"Drake Ave & Fullerton Ave",41.9244,-87.7154,95,90,0,0,95,90,185,185,0
"466",504,"Campbell Ave & Fullerton Ave",41.9246,-87.6893,111,97,0,0,111,97,208,208,0
"467",505,"Winchester Ave & Elston Ave",41.9241,-87.6765,89,94,0,0,89,94,183,183,0
"468",506,"Spaulding Ave & Armitage Ave",41.9171,-87.7102,170,144,0,0,170,144,314,314,0
"469",507,"Humboldt Blvd & Armitage Ave",41.9175,-87.7018,162,134,0,0,162,134,296,296,0
"470",508,"Central Park Ave & North Ave",41.9097,-87.7166,45,40,0,0,45,40,85,85,0
"471",509,"Troy St & North Ave",41.9098,-87.7053,100,103,0,0,100,103,203,203,0
"472",510,"Spaulding Ave & Division St",41.9027,-87.7092,55,49,0,0,55,49,104,104,0
"473",511,"Albany Ave & Bloomingdale Ave",41.914,-87.7051,192,178,0,0,192,178,370,370,0
"474",514,"Ridge Blvd & Howard St",42.0193,-87.6845,15,8,0,0,15,8,23,23,0
"475",515,"Paulina St & Howard St",42.0192,-87.6736,84,100,0,0,84,100,184,184,0
"476",517,"Clark St & Jarvis Ave",42.016,-87.675,50,48,0,0,50,48,98,98,0
"477",518,"Conservatory Dr & Lake St",41.8855,-87.7169,34,34,0,0,34,34,68,68,0
"478",519,"Wolcott Ave & Fargo Ave",42.017,-87.6777,16,16,0,0,16,16,32,32,0
"479",520,"Greenview Ave & Jarvis Ave",42.016,-87.6686,133,130,0,0,133,130,263,263,0
"480",522,"Bosworth Ave & Howard St",42.0195,-87.6696,26,28,0,0,26,28,54,54,0
"481",523,"Eastlake Ter & Rogers Ave",42.0209,-87.6651,151,145,0,0,151,145,296,296,0
"482",524,"Austin Blvd & Chicago Ave",41.8949,-87.7747,5,3,0,0,5,3,8,8,0
"483",525,"Glenwood Ave & Touhy Ave",42.0127,-87.6661,59,36,0,0,59,36,95,95,0
"484",526,"Oakley Ave & Touhy Ave",42.0123,-87.6882,24,25,0,0,24,25,49,49,0
"485",527,"Western Ave & Howard St",42.0189,-87.69,40,42,0,0,40,42,82,82,0
"486",528,"Pulaski Rd & Lake St",41.8854,-87.7265,4,7,0,0,4,7,11,11,0
"487",529,"Cicero Ave & Lake St",41.8868,-87.7453,5,5,0,0,5,5,10,10,0
"488",530,"Laramie Ave & Kinzie St",41.8878,-87.7555,1,2,0,0,1,2,3,3,0
"489",531,"Central Ave & Lake St",41.8877,-87.7655,1,0,0,0,1,0,0,0,0
"490",532,"Austin Blvd & Lake St",41.8879,-87.7744,13,20,0,0,13,20,33,33,0
"491",533,"Central Park Blvd & 5th Ave",41.8757,-87.7155,0,0,0,0,0,0,0,0,0
"492",534,"Karlov Ave & Madison St",41.8809,-87.7279,3,4,0,0,3,4,7,7,0
"493",535,"Pulaski Rd & Congress Pkwy",41.8743,-87.7257,5,5,0,0,5,5,10,10,0
"494",536,"Kostner Ave & Lake St",41.8859,-87.7354,1,0,0,0,1,0,0,0,0
"495",539,"Cicero Ave & Quincy St",41.8776,-87.7454,3,4,0,0,3,4,7,7,0
"496",540,"Laramie Ave & Madison St",41.8802,-87.7553,3,0,0,0,3,0,0,0,0
"497",541,"Central Ave & Harrison St",41.873,-87.7645,1,2,0,0,1,2,3,3,0
"498",542,"Central Ave & Madison St",41.8801,-87.7632,7,6,0,0,7,6,13,13,0
"499",544,"Austin Blvd & Madison St",41.8803,-87.7745,9,7,0,0,9,7,16,16,0
"500",545,"Kostner Ave & Adams St",41.8779,-87.7357,2,1,0,0,2,1,3,3,0
"501",546,"Damen Ave & Pershing Rd",41.8232,-87.6766,0,0,0,0,0,0,0,0,0
"502",547,"Ashland Ave & Pershing Rd",41.8235,-87.6656,19,12,0,0,19,12,31,31,0
"503",548,"Morgan St & Pershing Rd",41.8236,-87.6509,5,6,0,0,5,6,11,11,0
"504",549,"Marshfield Ave & 44th St",41.814,-87.6666,4,6,0,0,4,6,10,10,0
"505",550,"Central Ave & Chicago Ave",41.895,-87.7649,13,11,0,0,13,11,24,24,0
"506",551,"Hoyne Ave & 47th St",41.8082,-87.6772,5,6,0,0,5,6,11,11,0
"507",552,"Ashland Ave & McDowell Ave",41.8089,-87.6645,34,35,0,0,34,35,69,69,0
"508",553,"Elizabeth St & 47th St",41.8084,-87.6565,2,5,0,0,2,5,7,7,0
"509",554,"Damen Ave & 51st St",41.8009,-87.6747,2,2,0,0,2,2,4,4,0
"510",555,"Ashland Ave & 50th St",41.803,-87.6647,2,8,0,0,2,8,10,10,0
"511",556,"Throop St & 52nd St",41.7997,-87.6572,4,2,0,0,4,2,6,6,0
"512",557,"Seeley Ave & Garfield Blvd",41.7941,-87.6755,2,1,0,0,2,1,3,3,0
"513",558,"Ashland Ave & Garfield Blvd",41.7928,-87.6644,20,15,0,0,20,15,35,35,0
"514",559,"Racine Ave & Garfield Blvd",41.7942,-87.6551,10,12,0,0,10,12,22,22,0
"515",560,"Marshfield Ave & 59th St",41.7868,-87.6662,2,1,0,0,2,1,3,3,0
"516",562,"Racine Ave & 61st St",41.7832,-87.6544,2,0,0,0,2,0,0,0,0
"517",563,"Ashland Ave & 63rd St",41.7794,-87.6648,2,3,0,0,2,3,5,5,0
"518",566,"Ashland Ave & 69th St",41.7687,-87.6641,0,0,0,0,0,0,0,0,0
"519",567,"May St & 69th St",41.7689,-87.6529,1,1,0,0,1,1,2,2,0
"520",569,"Woodlawn Ave & 75th St",41.7592,-87.5958,2,1,0,0,2,1,3,3,0
"521",570,"Evans Ave & 75th St",41.7585,-87.6064,3,2,0,0,3,2,5,5,0
"522",571,"Vernon Ave & 75th St",41.7584,-87.6141,6,5,0,0,6,5,11,11,0
"523",572,"State St & 76th St",41.757,-87.6246,3,4,0,0,3,4,7,7,0
"524",573,"State St & 79th St",41.7508,-87.6244,8,6,0,0,8,6,14,14,0
"525",574,"Vernon Ave & 79th St",41.7509,-87.6138,1,0,0,0,1,0,0,0,0
"526",575,"Cottage Grove Ave & 78th St",41.7532,-87.605,7,10,0,0,7,10,17,17,0
"527",576,"Greenwood Ave & 79th St",41.7513,-87.5976,0,0,0,0,0,0,0,0,0
"528",577,"Stony Island Ave & South Chicago Ave",41.7512,-87.5853,2,3,0,0,2,3,5,5,0
"529",578,"Bennett Ave & 79th St",41.7518,-87.5785,0,0,0,0,0,0,0,0,0
"530",579,"Phillips Ave & 79th St",41.7518,-87.5652,2,2,0,0,2,2,4,4,0
"531",580,"Exchange Ave & 79th St",41.7517,-87.5528,2,2,0,0,2,2,4,4,0
"532",581,"Commercial Ave & 83rd St",41.7446,-87.5512,6,6,0,0,6,6,12,12,0
"533",582,"Phillips Ave & 83rd St",41.7445,-87.5651,0,0,0,0,0,0,0,0,0
"534",583,"Stony Island Ave & 82nd St",41.7466,-87.586,1,0,0,0,1,0,0,0,0
"535",585,"Cottage Grove Ave & 83rd St",41.7434,-87.6048,2,5,0,0,2,5,7,7,0
"536",586,"MLK Jr Dr & 83rd St",41.7431,-87.6148,4,5,0,0,4,5,9,9,0
"537",587,"Wabash Ave & 83rd St",41.7433,-87.6228,0,0,0,0,0,0,0,0,0
"538",589,"Milwaukee Ave & Cuyler Ave",41.9545,-87.7496,23,27,0,0,23,27,50,50,0
"539",590,"Kilbourn Ave & Irving Park Rd",41.9537,-87.7406,19,21,0,0,19,21,40,40,0
"540",591,"Kilbourn Ave & Milwaukee Ave",41.9488,-87.74,19,22,0,0,19,22,41,41,0
"541",592,"Knox Ave & Montrose Ave",41.9606,-87.7454,36,25,0,0,36,25,61,61,0
"542",593,"Halsted St & 59th St",41.7875,-87.6449,2,1,0,0,2,1,3,3,0
"543",594,"Western Blvd & 48th Pl",41.8057,-87.6834,9,21,0,0,9,21,30,30,0
"544",595,"Wabash Ave & 87th St",41.7366,-87.6226,12,11,0,0,12,11,23,23,0
"545",596,"Benson Ave & Church St",42.0482,-87.6835,167,177,0,0,167,177,344,344,0
"546",597,"Chicago Ave & Washington St",42.0326,-87.6791,113,102,0,0,113,102,215,215,0
"547",598,"Elmwood Ave & Austin St",42.0258,-87.6841,32,34,0,0,32,34,66,66,0
"548",599,"Valli Produce - Evanston Plaza",42.0397,-87.6994,15,20,0,0,15,20,35,35,0
"549",600,"Dodge Ave & Church St",42.0483,-87.6982,18,19,0,0,18,19,37,37,0
"550",601,"Central St Metra",42.0636,-87.6987,51,64,0,0,51,64,115,115,0
"551",602,"Central St & Girard Ave",42.0643,-87.6862,39,38,0,0,39,38,77,77,0
"552",603,"Chicago Ave & Sheridan Rd",42.0505,-87.6778,76,77,0,0,76,77,153,153,0
"553",604,"Sheridan Rd & Noyes St (NU)",42.0582,-87.6774,156,160,0,0,156,160,316,316,0
"554",605,"University Library (NU)",42.0529,-87.6734,112,125,0,0,112,125,237,237,0
"555",619,"Keystone Ave & Fullerton Ave",41.9246,-87.7279,24,27,0,0,24,27,51,51,0
"556",620,"Orleans St & Chestnut St (NEXT Apts)",41.8982,-87.6375,223,197,0,0,223,197,420,420,0
"557",621,"Aberdeen St & Randolph St",41.8841,-87.6543,327,352,0,0,327,352,679,679,0
"558",622,"California Ave & Cortez St",41.9004,-87.6967,166,153,0,0,166,153,319,319,0
"559",623,"Michigan Ave & 8th St",41.8728,-87.624,420,383,0,0,420,383,803,803,0
"560",624,"Dearborn St & Van Buren St",41.8763,-87.6292,276,252,0,0,276,252,528,528,0
"561",625,"Chicago Ave & Dempster St",42.0417,-87.6807,91,89,0,0,91,89,180,180,0
"562",626,"Delano Ct & Roosevelt Rd",41.8675,-87.6322,233,205,0,0,233,205,438,438,0
"563",627,"LaSalle Dr & Huron St",41.8949,-87.6323,425,409,0,0,425,409,834,834,0
"564",628,"Walsh Park",41.9146,-87.668,147,146,0,0,147,146,293,293,0
"565",630,"Kildare Ave & Montrose Ave",41.9611,-87.7357,22,11,0,0,22,11,33,33,0
"566",631,"Malcolm X College",41.8776,-87.6739,34,32,0,0,34,32,66,66,0
"567",632,"Clark St & Newport St",41.9445,-87.6547,288,263,0,0,288,263,551,551,0
"568",635,"Fairbanks St & Superior St",41.8957,-87.6201,348,354,0,0,348,354,702,702,0
"569",636,"Orleans St & Hubbard St",41.89,-87.6366,279,275,0,0,279,275,554,554,0
"570",637,"Wood St & Chicago Ave (*)",41.8956,-87.6721,198,216,0,0,198,216,414,414,0
"571",638,"Clinton St & Jackson Blvd",41.8781,-87.6398,564,572,0,0,564,572,1136,1136,0
"572",639,"Lakefront Trail & Wilson Ave",41.9658,-87.6454,316,306,0,0,316,306,622,622,0
"573",640,"Bernard St & Elston Ave",41.9499,-87.7139,36,42,0,0,36,42,78,78,0
"574",641,"Central Park Ave & Bloomingdale Ave",41.9142,-87.7168,71,78,0,0,71,78,149,149,0
"575",642,"Latrobe Ave & Chicago Ave",41.8947,-87.7569,1,3,0,0,1,3,4,4,0
"576",643,"Smith Park (*)",41.892,-87.6894,32,34,0,0,32,34,66,66,0
"577",644,"Western Ave & Fillmore St (*)",41.8686,-87.6862,105,103,0,0,105,103,208,208,0
"578",645,"Archer (Damen) Ave & 37th St",41.8267,-87.6831,29,25,0,0,29,25,54,54,0
"579",646,"State St & 54th St",41.7966,-87.6259,5,2,0,0,5,2,7,7,0
"580",648,"Carpenter St & 63rd St",41.7799,-87.6509,1,0,0,0,1,0,0,0,0
"581",649,"Stewart Ave & 63rd St (*)",41.7798,-87.6348,3,1,0,0,3,1,4,4,0
"582",653,"Cornell Dr & Hayes Dr",41.7806,-87.5848,3,2,0,0,3,2,5,5,0
"583",654,"Racine Ave & Washington Blvd (*)",41.8831,-87.657,153,161,0,0,153,161,314,314,0
"584",655,"Hoyne Ave & Balmoral Ave",41.9799,-87.6819,75,71,0,0,75,71,146,146,0
"585",656,"Damen Ave & Walnut (Lake) St (*)",41.886,-87.677,47,71,0,0,47,71,118,118,0
"586",657,"Wood St & Augusta Blvd",41.8992,-87.6722,290,274,0,0,290,274,564,564,0
"587",658,"Leavitt St & Division St (*)",41.903,-87.6838,124,132,0,0,124,132,256,256,0
"588",659,"Leavitt St & Chicago Ave",41.8955,-87.682,166,170,0,0,166,170,336,336,0
"589",660,"Sheridan Rd & Columbia Ave",42.0046,-87.6614,108,107,0,0,108,107,215,215,0
"590",661,"Evanston Civic Center",42.057,-87.6866,21,18,0,0,21,18,39,39,0
"591",662,"Dodge Ave & Mulford St",42.0235,-87.6996,17,20,0,0,17,20,37,37,0
"592",663,"Lincolnwood Dr & Central St",42.0649,-87.7153,28,29,0,0,28,29,57,57,0
"593",664,"Leavitt St & Belmont Ave (*)",41.9394,-87.6833,110,98,0,0,110,98,208,208,0
"594",666,"Cherry Ave & Blackhawk St",41.9072,-87.6556,57,67,0,0,57,67,124,124,0
"595",670,"MTL-ECO5.1-01",41.9171,-87.7482,5,5,0,0,5,5,10,10,0
"596",671,"HUBBARD ST BIKE CHECKING (LBS-WH-TEST)",41.89,-87.6807,2,10,0,0,2,10,12,12,0
"597",672,"Franklin St & Illinois St",41.891,-87.6355,463,457,0,0,463,457,920,920,0
"598",673,"Lincoln Park Conservatory",41.9239,-87.6358,310,316,0,0,310,316,626,626,0
"599",675,"HQ QR",41.8899,-87.6803,3210,3210,0,0,3210,3210,6420,6420,0
"600",0,"",0,0,0,0,0,0,0,0,0,0,0
