"","station_id","station_name","lat","long","start_n","end_n","e_start_n","e_end_n","c_start_n","c_end_n","total","classic","electric"
"1","","",41.89,-87.62,14848,16727,14848,16345,0,0,31575,0,31193
"2","13001","Michigan Ave & Washington St",41.8842013333333,-87.6234898333333,1208,1212,164,165,811,807,2420,1618,329
"3","13006","LaSalle St & Washington St",41.882664,-87.63253,652,652,154,147,461,465,1304,926,301
"4","13008","Millennium Park",41.881032,-87.624084,1757,1869,249,239,971,1074,3626,2045,488
"5","13011","Canal St & Adams St",41.879255,-87.639904,734,716,119,119,564,558,1450,1122,238
"6","13016","St. Clair St & Erie St",41.8942293333333,-87.6226,1326,1450,304,299,922,1009,2776,1931,603
"7","13017","Franklin St & Chicago Ave",41.8967469730938,-87.6356676220894,696,707,163,168,510,521,1403,1031,331
"8","13021","Clinton St & Lake St",41.885552,-87.6417265,747,782,172,171,554,592,1529,1146,343
"9","13022","Streeter Dr & Grand Ave",41.892278,-87.612043,2074,2039,284,266,1282,1252,4113,2534,550
"10","13028","900 W Harrison St",41.874754,-87.649807,328,327,69,66,239,240,655,479,135
"11","13029","Field Museum",41.865312,-87.617867,337,229,47,26,188,139,566,327,73
"12","13033","Milwaukee Ave & Grand Ave",41.8916533333333,-87.6482806666667,816,820,223,225,540,545,1636,1085,448
"13","13034","Michigan Ave & Pearson St",41.89766,-87.62351,798,839,140,135,527,558,1637,1085,275
"14","13036","Michigan Ave & Madison St",41.882134,-87.625125,628,657,144,144,377,420,1285,797,288
"15","13037","Clinton St & Tilden St",41.8758565,-87.6407848333333,164,154,35,40,125,105,318,230,75
"16","13042","Michigan Ave & Oak St",41.90096,-87.623777,1515,1714,281,272,992,1175,3229,2167,553
"17","13045","Dearborn St & Erie St",41.893992,-87.629318,1527,1631,483,479,976,1102,3158,2078,962
"18","13050","State St & Kinzie St",41.889187,-87.627754,870,942,155,156,625,684,1812,1309,311
"19","13053","Green St & Randolph St",41.883668,-87.64867,762,843,237,233,491,574,1605,1065,470
"20","13056","Canal St & Monroe St",41.8817018333333,-87.6395048333333,268,237,60,59,185,159,505,344,119
"21","13058","Dayton St & North Ave",41.9106156666667,-87.649435,538,565,121,119,392,429,1103,821,240
"22","13059","Bissell St & Armitage Ave",41.91844,-87.65222,908,933,173,173,703,721,1841,1424,346
"23","13061","Ashland Ave & Division St",41.90345,-87.667747,1067,1057,296,294,718,707,2124,1425,590
"24","13063","Sheridan Rd & Irving Park Rd",41.954245,-87.654406,653,681,129,132,506,534,1334,1040,261
"25","13068","Western Ave & Winnebago Ave",41.9156176666667,-87.686929,407,413,105,105,288,296,820,584,210
"26","13071","Southport Ave & Roscoe St",41.943739,-87.66402,853,894,175,175,642,684,1747,1326,350
"27","13073","Ashland Ave & Lake St",41.88592,-87.66717,181,173,59,59,116,109,354,225,118
"28","13074","Broadway & Wilson - Truman College Vaccination Site",41.9651966666667,-87.6583265,399,407,95,91,285,297,806,582,186
"29","13075","Wentworth Ave & Cermak Rd",41.8530845574128,-87.6319313049316,363,431,62,65,240,304,794,544,127
"30","13080","Hermitage Ave & Polk St",41.871514,-87.669886,14,17,0,0,0,0,31,0,0
"31","13081","Ogden Ave & Congress Pkwy",41.87501,-87.67328,132,114,36,20,95,92,246,187,56
"32","13083","Indiana Ave & 40th St",41.82168,-87.6216,50,42,5,6,43,31,92,74,11
"33","13084","California Ave & Milwaukee Ave",41.922695,-87.697153,404,390,156,152,233,213,794,446,308
"34","13085","Kedzie Ave & Milwaukee Ave",41.929567,-87.707857,500,507,146,145,315,319,1007,634,291
"35","13089","Damen Ave & Cullerton St",41.8549665187539,-87.6756995916366,118,119,35,35,81,80,237,161,70
"36","13091","Western Ave & 21st St",41.854109,-87.685838,127,133,54,55,69,70,260,139,109
"37","13096","California Ave & 21st St",41.8538040657915,-87.6957423985004,69,80,14,14,46,61,149,107,28
"38","13099","Halsted St & 18th St",41.8576185,-87.6460843333333,137,134,31,30,99,98,271,197,61
"39","13102","Calumet Ave & 18th St",41.8576415,-87.6195243333333,487,497,84,79,381,394,984,775,163
"40","13108","Broadway & Argyle St",41.973815,-87.65966,431,435,83,81,330,337,866,667,164
"41","13109","Broadway & Berwyn Ave",41.978353,-87.659753,406,430,74,76,321,333,836,654,150
"42","13124","Cannon Dr & Fullerton Ave",41.9267559875,-87.6344287848,399,433,54,52,228,260,832,488,106
"43","13128","Clark St & North Ave",41.911974,-87.631942,607,613,105,104,443,460,1220,903,209
"44","13132","Damen Ave & Chicago Ave",41.895769,-87.67722,509,559,134,132,354,407,1068,761,266
"45","13133","Damen Ave & Cortland St",41.915983,-87.677335,566,575,98,94,430,443,1141,873,192
"46","13134","Damen Ave & Madison St",41.88137,-87.67493,199,235,65,64,125,159,434,284,129
"47","13135","Blue Island Ave & 18th St",41.8573998333333,-87.6616038333333,288,300,78,81,196,208,588,404,159
"48","13136","Damen Ave & Division St",41.903266,-87.678435,458,451,112,100,328,335,909,663,212
"49","13137","Broadway & Barry Ave",41.9375823160063,-87.6440978050232,1341,1372,231,227,1051,1092,2713,2143,458
"50","13138","Canal St & Jackson Blvd",41.877245,-87.639366,211,176,39,38,162,130,387,292,77
"51","13139","Throop St & Taylor St",41.868968,-87.659141,345,347,54,57,284,282,692,566,111
"52","13143","Damen Ave & Melrose Ave",41.9406,-87.6785,146,148,48,47,90,95,294,185,95
"53","13144","Seeley Ave & Roscoe St",41.9434026666667,-87.6796235,232,272,69,72,157,187,504,344,141
"54","13146","Clark St & Armitage Ave",41.918306,-87.636282,1291,1269,285,277,906,879,2560,1785,562
"55","13150","Michigan Ave & 18th St",41.857813,-87.62455,457,470,75,70,363,374,927,737,145
"56","13154","Sheffield Ave & Kingsbury St",41.910522,-87.653106,806,820,178,177,597,635,1626,1232,355
"57","13155","Racine Ave & Randolph St",41.884069,-87.656853,226,233,56,54,162,173,459,335,110
"58","13156","Aberdeen St & Monroe St",41.880419,-87.655519,499,528,112,112,370,383,1027,753,224
"59","13157","Aberdeen St & Jackson Blvd",41.8777203333333,-87.6547795,569,545,136,132,414,392,1114,806,268
"60","13158","Peoria St & Jackson Blvd",41.8776415962753,-87.6496177911758,692,690,140,135,532,535,1382,1067,275
"61","13160","May St & Taylor St",41.8694821,-87.6554864,387,338,76,63,283,255,725,538,139
"62","13162","Halsted St & 21st St",41.8537798107274,-87.6466029882431,109,117,13,12,90,102,226,192,25
"63","13163","Morgan St & 18th St",41.858086,-87.651073,181,172,33,32,134,130,353,264,65
"64","13164","Racine Ave & 18th St",41.858166,-87.656495,366,350,84,81,269,253,716,522,165
"65","13165","Racine Ave & 13th St",41.865054,-87.656959,39,33,12,15,26,18,72,44,27
"66","13179","Clark St & Lincoln Ave",41.915795,-87.6346535,1172,1182,250,245,829,815,2354,1644,495
"67","13191","Sedgwick St & Webster Ave",41.9222206666667,-87.6389385,763,773,201,201,545,541,1536,1086,402
"68","13192","Halsted St & Dickens Ave",41.919936,-87.64883,732,789,170,172,539,603,1521,1142,342
"69","13193","Larrabee St & Webster Ave",41.921822,-87.64414,1123,1134,205,203,845,878,2257,1723,408
"70","13194","Ogden Ave & Race Ave",41.891795,-87.658751,518,530,134,135,374,383,1048,757,269
"71","13196","Carpenter St & Huron St",41.894556,-87.653449,410,353,129,117,270,224,763,494,246
"72","13197","Elizabeth (May) St & Fulton St",41.8866164860277,-87.6580399274826,219,221,60,58,154,155,440,309,118
"73","13206","Loomis St & Jackson Blvd",41.877945,-87.662007,279,294,57,54,214,235,573,449,111
"74","13213","State St & 29th St",41.841707,-87.626938,16,22,1,2,12,16,38,28,3
"75","13215","Rhodes Ave & 32nd St",41.836208,-87.613533,184,182,52,52,119,113,366,232,104
"76","13216","State St & 33rd St",41.834734,-87.625813,467,497,71,77,381,408,964,789,148
"77","13217","Calumet Ave & 33rd St",41.8349,-87.61793,212,194,28,29,171,157,406,328,57
"78","13221","Wood St & Milwaukee Ave",41.9077091666667,-87.672582,652,653,142,138,477,478,1305,955,280
"79","13224","Ashland Ave & Blackhawk St",41.9070493333333,-87.6672715,483,461,122,107,344,343,944,687,229
"80","13229","Southport Ave & Belmont Ave",41.9394777504051,-87.6637476682663,435,441,125,119,294,312,876,606,244
"81","13235","Southport Ave & Waveland Ave",41.94815,-87.66394,846,909,134,135,688,747,1755,1435,269
"82","13241","Western Ave & Division St",41.902893,-87.687275,273,231,102,88,159,132,504,291,190
"83","13242","Milwaukee Ave & Rockwell St",41.9201955620057,-87.6926591992378,256,232,60,55,189,167,488,356,115
"84","13243","Milwaukee Ave & Wabansia Ave",41.912616,-87.681391,647,675,164,162,448,488,1322,936,326
"85","13245","Claremont Ave & Hirsch St",41.907781,-87.685854,126,127,30,32,87,89,253,176,62
"86","13247","Ashland Ave & Chicago Ave",41.895966,-87.667747,442,418,105,96,316,302,860,618,201
"87","13248","Ashland Ave & Augusta Blvd",41.8996198333333,-87.668478,341,311,73,57,259,243,652,502,130
"88","13249","Ashland Ave & Belle Plaine Ave",41.9560705,-87.6689321666667,161,171,24,25,131,142,332,273,49
"89","13253","Lincoln Ave & Waveland Ave",41.948797,-87.675278,314,301,91,92,215,204,615,419,183
"90","13256","California Ave & Division St",41.903029,-87.697474,249,260,66,65,156,162,509,318,131
"91","13257","Campbell Ave & North Ave",41.910535,-87.689556,294,275,97,91,178,164,569,342,188
"92","13258","California Ave & North Ave",41.91044,-87.6972,243,228,63,58,150,142,471,292,121
"93","13259","California Ave & Francis Pl (Temp)",41.9185818333333,-87.6974808333333,255,222,87,82,155,133,477,288,169
"94","13263","Columbus Dr & Randolph St",41.8845613333333,-87.6193521666667,1426,967,311,243,952,594,2393,1546,554
"95","13265","Kingsbury St & Erie St",41.8938566666667,-87.641874,938,861,238,216,691,630,1799,1321,454
"96","13266","Stave St & Armitage Ave",41.9177411666667,-87.6914098333333,202,198,77,77,116,112,400,228,154
"97","13268","Damen Ave & Wellington Ave",41.93588,-87.67842,172,154,30,28,136,121,326,257,58
"98","13269","Ashland Ave & Wellington Ave",41.936083,-87.669807,303,320,60,56,237,259,623,496,116
"99","13271","Damen Ave & Clybourn Ave",41.931931,-87.677856,261,268,72,67,182,191,529,373,139
"100","13276","Stockton Dr & Wrightwood Ave",41.93132,-87.638742,861,862,168,160,643,647,1723,1290,328
"101","13277","Broadway & Belmont Ave",41.9400581666667,-87.6454136666667,732,779,140,143,563,611,1511,1174,283
"102","13278","Broadway & Cornelia Ave",41.9454845,-87.6465011666667,1107,1097,243,241,826,823,2204,1649,484
"103","13285","Wood St & Taylor St (Temp)",41.8692652184382,-87.6737308502197,455,461,71,87,379,367,916,746,158
"104","13288","Damen Ave & Charleston St",41.920082,-87.677855,322,326,90,89,192,203,648,395,179
"105","13289","Eckhart Park",41.896373,-87.660984,446,450,109,112,318,321,896,639,221
"106","13290","Noble St & Milwaukee Ave",41.9008341666667,-87.6626378333333,489,474,76,72,399,396,963,795,148
"107","13292","Kedzie Ave & Palmer Ct",41.9215155,-87.7073343333333,263,242,81,72,170,156,505,326,153
"108","13294","Greenview Ave & Diversey Pkwy",41.9325896342979,-87.6659363508224,297,281,56,56,230,218,578,448,112
"109","13296","Ashland Ave & Wrightwood Ave",41.92883,-87.668507,252,226,53,48,186,169,478,355,101
"110","13300","Lake Shore Dr & Monroe St",41.880958,-87.616743,2453,2380,255,241,1433,1452,4833,2885,496
"111","13303","Clark St & Chicago Ave",41.89675,-87.63089,764,653,158,157,574,461,1417,1035,315
"112","13304","Racine Ave & 15th St",41.861267,-87.656625,111,96,13,11,91,78,207,169,24
"113","13307","Laflin St & Cullerton St",41.8549145757657,-87.6635599136353,119,107,21,19,93,86,226,179,40
"114","13319","Ashland Ave & Grace St",41.950687,-87.6687,293,270,55,54,222,202,563,424,109
"115","13323","Broadway & Sheridan Rd",41.9527851666667,-87.6500288333333,609,594,114,118,464,450,1203,914,232
"116","13325","Broadway & Waveland Ave",41.949074,-87.648636,1098,1097,206,199,852,877,2195,1729,405
"117","13326","Canal St & Harrison St",41.874255,-87.639573,96,105,7,8,84,85,201,169,15
"118","13331","May St & Cullerton St",41.855136,-87.654127,122,135,20,21,87,91,257,178,41
"119","13332","Loomis St & Lexington St",41.872187,-87.661501,732,710,144,143,574,554,1442,1128,287
"120","13338","Mies van der Rohe Way & Chicago Ave",41.896987,-87.6216051666667,798,848,157,158,578,616,1646,1194,315
"121","13341","Canal St & Madison St",41.882091,-87.639833,520,516,123,122,355,349,1036,704,245
"122","13345","Calumet Ave & 35th St",41.831402,-87.6180573333333,90,83,10,4,78,76,173,154,14
"123","13353","Ada St & Washington Blvd",41.8828916666667,-87.6612861666667,475,477,103,97,358,362,952,720,200
"124","13354","Ashland Ave & 13th St",41.865234,-87.666507,116,143,28,27,83,111,259,194,55
"125","13379","Clarendon Ave & Gordon Ter",41.9578665241517,-87.6495051383972,599,559,86,83,497,462,1158,959,169
"126","13389","Clarendon Ave & Junior Ter",41.9609951666667,-87.6496095,576,557,114,117,449,411,1133,860,231
"127","13398","Blackstone Ave & Hyde Park Blvd",41.8025893333333,-87.5903203333333,314,272,38,33,249,212,586,461,71
"128","13409","Sangamon St & Washington Blvd",41.883165,-87.6511,357,378,98,102,248,254,735,502,200
"129","13420","MLK Jr Dr & Pershing Rd",41.8246,-87.61678,66,65,13,15,39,42,131,81,28
"130","13427","Cityfront Plaza Dr & Pioneer Ct",41.8904171666667,-87.6220643333333,656,594,162,136,431,376,1250,807,298
"131","13430","LaSalle St & Illinois St",41.890762,-87.631697,1026,1074,217,215,717,757,2100,1474,432
"132","13431","Adler Planetarium",41.866095,-87.607267,756,727,103,87,501,480,1483,981,190
"133","13432","Wood St & Hubbard St",41.889899,-87.671473,186,177,55,55,124,119,363,243,110
"134","13434","Ashland Ave & Grand Ave",41.891072,-87.666611,275,282,62,58,201,218,557,419,120
"135","15442","Ashland Ave & Archer Ave",41.83920868403,-87.6656098589,75,64,9,11,66,50,139,116,20
"136","15443","Shields Ave & 28th Pl",41.842733,-87.635491,118,119,14,21,104,97,237,201,35
"137","15445","Wentworth Ave & 33rd St",41.83452988563,-87.6318229814,91,94,9,11,78,78,185,156,20
"138","15446","Racine Ave & 35th St",41.83069611252,-87.6559759116,61,76,7,7,50,66,137,116,14
"139","15449","State St & Pershing Rd",41.82301523798,-87.6265680185,11,10,3,3,6,6,21,12,6
"140","15470","Calumet Ave & 51st St",41.8022991666667,-87.6180651666667,55,48,11,11,41,34,103,75,22
"141","15491","63rd St Beach",41.7811656666667,-87.5760195,92,92,20,21,48,52,184,100,41
"142","15529","Mies van der Rohe Way & Chestnut St",41.8985866514,-87.6219152258,913,950,142,139,704,705,1863,1409,281
"143","15530","Rush St & Superior St",41.89576474564,-87.6259080327,927,1000,208,205,664,723,1927,1387,413
"144","15534","Field Blvd & South Water St",41.886349,-87.617517,635,615,205,193,352,372,1250,724,398
"145","15535","Desplaines St & Randolph St",41.8846128333333,-87.6445366666667,560,516,149,128,372,367,1076,739,277
"146","15539","Desplaines St & Jackson Blvd",41.8780868333333,-87.6441535,722,695,164,163,547,514,1417,1061,327
"147","15541","Buckingham Fountain",41.876511228817,-87.6205480098724,652,609,87,66,329,285,1261,614,153
"148","15542","Clinton St & Polk St",41.87146651779,-87.6409491327,95,94,9,8,72,81,189,153,17
"149","15544","Shedd Aquarium",41.86722595682,-87.6153553902,1339,1178,148,115,737,679,2517,1416,263
"150","15545","Burnham Harbor",41.856268,-87.613348,697,668,64,56,577,566,1365,1143,120
"151","15546","Calumet Ave & 21st St",41.8541231666667,-87.6191488333333,102,113,19,19,74,85,215,159,38
"152","15550","Canal St & Taylor St",41.870257,-87.639474,257,279,42,42,178,218,536,396,84
"153","15571","Broadway & Granville Ave",41.9947796884,-87.6602845349,441,443,84,85,340,322,884,662,169
"154","15575","Broadway & Thorndale Ave",41.98974251144,-87.6601406209,331,345,61,62,237,253,676,490,123
"155","15578","Broadway & Ridge Ave",41.9840446107,-87.6602738295,294,264,55,55,220,191,558,411,110
"156","15585","Budlong Woods Library",41.98366470886,-87.6964225611,58,55,13,12,39,34,113,73,25
"157","15597","Halsted St & 69th St",41.769062,-87.644614,1,1,0,0,0,0,2,0,0
"158","15599","Calumet Ave & 71st St",41.765508,-87.616918,3,9,0,0,2,8,12,10,0
"159","15615","Christiana Ave & Lawrence Ave",41.968328,-87.711793,57,63,16,12,41,49,120,90,28
"160","15621","Albany Ave & Montrose Ave",41.961041,-87.705866,92,83,26,26,63,54,175,117,52
"161","15622","California Ave & Montrose Ave",41.9611223333333,-87.6954008333333,153,155,41,41,94,97,308,191,82
"162","15623","Campbell Ave & Montrose Ave",41.9615816666667,-87.6911811666667,192,202,61,61,131,138,394,269,122
"163","15624","Avondale Ave & Irving Park Rd",41.953393,-87.732002,72,51,28,25,43,24,123,67,53
"164","15628","California Ave & Byron St",41.9521353333333,-87.6980846666667,145,161,43,45,84,96,306,180,88
"165","15631","Troy St & Elston Ave",41.94524356848,-87.7066499009,129,150,39,36,85,112,279,197,75
"166","15632","Talman Ave & Addison St",41.9466481666667,-87.69461,81,85,21,22,53,56,166,109,43
"167","15634","Western Ave & Roscoe St",41.943034,-87.687288,107,129,36,36,69,82,236,151,72
"168","15640","Avers Ave & Belmont Ave",41.939408,-87.723574,71,64,17,21,49,37,135,86,38
"169","15642","California Ave & Fletcher St",41.9384813333333,-87.698017,154,167,46,45,89,114,321,203,91
"170","15643","Kosciuszko Park",41.9305951666667,-87.7239033333333,107,112,48,46,46,51,219,97,94
"171","15644","Central Park Ave & Elbridge Ave",41.93533728263,-87.7168892935,130,127,48,46,75,71,257,146,94
"172","15645","Richmond St & Diversey Ave",41.9319678333333,-87.7011681666667,103,118,27,29,74,86,221,160,56
"173","15646","California Ave & Altgeld St",41.92669,-87.697668,240,232,113,110,117,112,472,229,223
"174","15648","Campbell Ave & Fullerton Ave",41.92463247165,-87.6893070063,159,176,73,74,81,96,335,177,147
"175","15650","Spaulding Ave & Armitage Ave",41.9171080347893,-87.7102209627628,179,171,81,79,86,75,350,161,160
"176","15651","Humboldt Blvd & Armitage Ave",41.91751339399,-87.7018089555,256,234,107,89,130,134,490,264,196
"177","15652","Central Park Ave & North Ave",41.90965687563,-87.7166319516,70,53,18,15,52,36,123,88,33
"178","15653","Troy St & North Ave",41.909769,-87.70528,161,151,44,44,106,94,312,200,88
"179","15654","Spaulding Ave & Division St",41.9027241666667,-87.7092596666667,115,105,46,44,63,61,220,124,90
"180","15655","Albany Ave & Bloomingdale Ave",41.91402671273,-87.705126462,232,206,77,79,136,107,438,243,156
"181","15664","Artesian Ave & Hubbard St",41.88949181977,-87.6882193648,103,102,54,52,49,49,205,98,106
"182","15666","California Ave & Lake St",41.88445395657,-87.6962981368,32,22,10,6,20,14,54,34,16
"183","15667","Western Ave & Monroe St",41.8797877089,-87.686112808,73,80,22,24,47,54,153,101,46
"184","15668","Western Ave & Congress Pkwy",41.87474885079,-87.6864452757,76,70,19,13,52,50,146,102,32
"185","15682","Kedzie Ave & Roosevelt Rd",41.86649278172,-87.7064961757,17,17,12,11,5,6,34,11,23
"186","15685","Central Park Ave & Ogden Ave",41.8540635038745,-87.7151173353195,40,34,16,12,24,21,74,45,28
"187","15686","Kedzie Ave & 21st St",41.853496,-87.7051251666667,19,16,5,5,13,10,35,23,10
"188","15687","Central Park Ave & 24th St",41.8481,-87.715068,24,10,13,5,9,5,34,14,18
"189","15689","California Ave & 23rd Pl",41.8491678333333,-87.6951455,70,56,18,10,49,43,126,92,28
"190","15691","Albany Ave & 26th St",41.8445456666667,-87.7020525,27,28,16,11,10,17,55,27,27
"191","15692","California Ave & 26th St",41.84404,-87.695296,9,3,4,1,3,2,12,5,5
"192","16010","Keystone Ave & Fullerton Ave",41.92459,-87.72785,37,52,15,14,21,34,89,55,29
"193","16806","Bosworth Ave & Howard St",42.019537,-87.669563,26,23,6,6,20,17,49,37,12
"194","16903","Cicero Ave & Lake St",41.886841,-87.745261,13,9,0,0,12,9,22,21,0
"195","16905","Central Ave & Lake St",41.8877078333333,-87.7654238333333,13,18,10,10,2,5,31,7,20
"196","16906","Austin Blvd & Lake St",41.8879115,-87.7744145,25,23,19,18,5,5,48,10,37
"197","16907","Central Park Blvd & 5th Ave",41.8756698333333,-87.7155376666667,47,51,37,40,6,7,98,13,77
"198","16912","Cicero Ave & Flournoy St",41.8721235,-87.7466193333333,2,9,2,5,0,0,11,0,7
"199","16913","Cicero Ave & Quincy St",41.8776358333333,-87.7454258333333,5,7,1,2,4,4,12,8,3
"200","16915","Central Ave & Harrison St",41.8729973333333,-87.7644945,6,7,3,2,3,3,13,6,5
"201","16916","Central Ave & Madison St",41.8801623333333,-87.7631948333333,6,7,2,1,4,6,13,10,3
"202","16918","Austin Blvd & Madison St",41.880281,-87.774453,27,23,10,6,10,9,50,19,16
"203","16920","Central Ave & Chicago Ave",41.894958,-87.764902,56,45,29,23,22,17,101,39,52
"204","16921","Austin Blvd & Chicago Ave",41.8949408333333,-87.7743778333333,11,9,6,3,5,6,20,11,9
"205","16932","Ashland Ave & Pershing Rd",41.823465,-87.665577,10,17,1,0,9,17,27,26,0
"206","16933","Morgan St & Pershing Rd",41.823613,-87.650931,8,12,0,0,8,12,20,20,0
"207","16937","Ashland Ave & McDowell Ave",41.80887,-87.66454,14,7,1,1,13,6,21,19,2
"208","16940","Ashland Ave & 50th St",41.803023,-87.664699,12,13,3,3,6,8,25,14,6
"209","16943","Ashland Ave & Garfield Blvd",41.792822,-87.664429,1,0,0,0,1,0,0,0,0
"210","16948","Ashland Ave & 63rd St",41.7793753333333,-87.6648995,5,4,3,1,1,2,9,3,4
"211","16950","Ashland Ave & 66th St",41.774074,-87.663815,2,4,0,0,2,1,6,3,0
"212","16953","Vincennes Ave & 75th St",41.75797,-87.63121,1,1,0,0,1,1,2,2,0
"213","16970","Bennett Ave & 79th St",41.751785,-87.578496,7,4,0,0,4,3,11,7,0
"214","16991","Milwaukee Ave & Cuyler Ave",41.954468,-87.749594,48,58,26,28,19,24,106,43,54
"215","16994","Kilbourn Ave & Milwaukee Ave",41.948818,-87.74002,25,13,10,7,14,5,38,19,17
"216","17660","California Ave & Cortez St",41.900363,-87.696704,234,259,98,96,120,151,493,271,194
"217","18003","Fairbanks St & Superior St",41.8958071666667,-87.62033,547,580,131,130,391,413,1127,804,261
"218","18016","Bernard St & Elston Ave",41.949923,-87.713949,89,81,28,26,57,52,170,109,54
"219","18017","Central Park Ave & Bloomingdale Ave",41.914166,-87.716755,169,161,19,14,120,112,330,232,33
"220","18022","Archer (Damen) Ave & 37th St",41.826712,-87.683144,58,60,21,21,31,28,118,59,42
"221","18058","Leavitt St & Chicago Ave",41.895501,-87.682017,260,262,57,49,198,211,522,409,106
"222","18062","Aberdeen St & Randolph St",41.884135,-87.6542743333333,427,471,114,116,296,338,898,634,230
"223","18067","Walsh Park",41.91461,-87.667968,299,269,29,28,245,216,568,461,57
"224","18069","Cherry Ave & Blackhawk St",41.9072551666667,-87.6555968333333,57,65,6,6,48,59,122,107,12
"225","20.0","Damen Ave & Wabansia Ave",41.91,-87.68,8,7,8,7,0,0,15,0,15
"226","20101","Summit Ave & 86th St",41.737848,-87.6449,4,5,0,0,2,2,9,4,0
"227","20103","Prospect Sq & 91st St",41.727951,-87.6676165,14,13,1,1,3,3,27,6,2
"228","20104","State St & 95th St",41.7216201666667,-87.622827,29,17,13,11,12,5,46,17,24
"229","20105","Halsted St & 96th St",41.7197121836188,-87.6430195569992,1,1,0,0,1,1,2,2,0
"230","20106","Chicago State University",41.7189583333333,-87.6083773333333,16,13,16,11,0,0,29,0,27
"231","20107","Walden Pkwy & 100th St",41.712164103598,-87.6677334308624,11,9,2,1,9,8,20,17,3
"232","20108","Hale Ave & 107th St",41.6992061681277,-87.668918967247,1,4,0,0,1,4,5,5,0
"233","20109","Vernon Ave & 107th St",41.7001213792389,-87.6122599840164,11,7,6,2,4,5,18,9,8
"234","20110","Eberhart Ave & 91st St",41.729425,-87.609529,5,4,0,0,3,2,9,5,0
"235","20112","Indiana Ave & 103rd St",41.7071702711776,-87.6184719800949,7,6,0,0,7,6,13,13,0
"236","20113","Dauphin Ave & 103rd St",41.7072503677818,-87.6076626777649,4,7,1,1,3,5,11,8,2
"237","20116","Dauphin Ave & 87th St",41.736559,-87.601258,17,16,2,2,13,14,33,27,4
"238","20118","Eggleston Ave & 92nd St",41.7275586666667,-87.634862,13,6,10,1,3,5,19,8,11
"239","20119","Elizabeth St & 92nd St",41.7267989637012,-87.6542901992798,26,22,10,10,12,8,48,20,20
"240","20120","Stewart Ave & 83rd St",41.7437256666667,-87.6340986666667,7,9,4,2,1,6,16,7,6
"241","20121","Loomis Blvd & 84th St",41.7414865286181,-87.6584100723267,3,3,0,0,3,3,6,6,0
"242","20123","Western Ave & 104th St",41.7045871021891,-87.6812034845352,6,6,2,2,4,4,12,8,4
"243","20124","Vincennes Ave & 104th St",41.704926,-87.656868,3,3,1,1,1,1,6,2,2
"244","20125","Halsted St & 104th St",41.7051397889324,-87.6424241065979,0,0,0,0,0,0,0,0,0
"245","20127","Halsted St & 111th St",41.6922625558917,-87.6426118612289,9,6,1,1,7,4,15,11,2
"246","20128","S Wentworth Ave & W 111th St",41.69,-87.63,2,2,2,2,0,0,4,0,4
"247","20129","Ada St & 113th St",41.6875616233574,-87.6554757356644,2,1,0,0,2,1,3,3,0
"248","20130","Wentworth Ave & 104th St",41.705308,-87.629217,2,0,0,0,0,0,0,0,0
"249","20131","Cottage Grove Ave & 111th Pl",41.6917097584701,-87.6100015640259,8,7,2,1,6,6,15,12,3
"250","20203","Lawndale Ave & 111th St",41.6913191922107,-87.7128857374191,16,12,1,0,8,5,28,13,0
"251","20204","Kedzie Ave & 110th St",41.6924015,-87.7009578333333,4,2,2,1,2,1,6,3,3
"252","20205","Western Ave & 111th St",41.691211,-87.681297,5,5,3,1,0,0,10,0,4
"253","20206","Homewood Ave & 115th St",41.684595,-87.670708,3,3,0,0,2,2,6,4,0
"254","20207","Major Taylor Trail & 115th St",41.684931595193,-87.6452887058258,1,3,0,0,1,3,4,4,0
"255","20208","Major Taylor Trail & 124th St",41.6686963533225,-87.6371133327484,4,4,0,0,4,4,8,8,0
"256","20210","State St & 123rd St",41.670685,-87.6226815,9,8,2,2,6,5,17,11,4
"257","20211","Eberhart Ave & 131st St",41.6580141666667,-87.6107816666667,7,2,6,0,1,2,9,3,0
"258","20213","Commercial Ave & 130th St",41.65915,-87.550762,9,14,5,3,3,10,23,13,8
"259","20214","Avenue O & 134th St",41.6519038333333,-87.5395528333333,8,9,8,9,0,0,17,0,17
"260","20215","Hegewisch Metra Station",41.6485007626641,-87.546089887619,5,4,1,0,4,4,9,8,0
"261","20217","Torrence Ave & 126th Pl",41.6662868333333,-87.5571641666667,9,2,1,1,8,1,11,9,2
"262","20218","Avenue O & 118th St",41.6810014591104,-87.5379312226869,8,6,4,2,4,4,14,8,6
"263","20220","Avenue L & 114th St",41.69,-87.54,0,0,0,0,0,0,0,0,0
"264","20221","Torrence Ave & 106th St",41.7028495,-87.5598091666667,4,2,1,1,3,1,6,4,2
"265","20222","Burnham Greenway & 105th St",41.7045750872071,-87.5282317399979,18,15,1,0,13,13,33,26,0
"266","20223","Ewing Ave & Burnham Greenway",41.712748761095,-87.5348138809204,9,7,2,0,6,5,16,11,0
"267","20225","Commercial Ave & 100th St",41.7132835,-87.5511603333333,1,0,1,0,0,0,0,0,0
"268","20226","Oglesby Ave & 100th St",41.7132736666667,-87.5658636666667,2,4,2,0,0,0,6,0,0
"269","20227","Bradley Park",41.717878301935,-87.5645917654037,3,1,2,0,1,1,4,2,0
"270","20228","Constance Ave & 95th St",41.7222907409526,-87.5789684057236,5,3,0,0,5,1,8,6,0
"271","20229","Baltimore Ave & 87th St",41.7373356004167,-87.5485146045685,9,9,3,3,6,6,18,12,6
"272","20230","Clyde Ave & 87th St",41.7371514643106,-87.572740316391,9,7,1,1,8,6,16,14,2
"273","20231","East End Ave & 87th St",41.7368152144067,-87.5828012824059,5,6,1,1,3,3,11,6,2
"274","20232","Big Marsh Park",41.6858770556233,-87.573823928833,20,20,3,3,7,7,40,14,6
"275","20233","Halsted St & 78th St",41.7524870124901,-87.6439021574879,4,4,1,1,3,3,8,6,2
"276","20234","Ashland Ave & 78th St",41.7522048494112,-87.663699388504,6,4,0,0,2,3,10,5,0
"277","20235","Greenwood Ave & 91st St",41.7282642681627,-87.5972986221313,6,2,4,2,2,0,8,0,6
"278","20236","Stony Island Ave & 90th St",41.7313949433024,-87.5857436656952,3,2,1,0,2,0,5,0,0
"279","20238","Greenwood Ave & 97th St",41.7187031547574,-87.5970357656479,10,11,0,0,8,8,21,16,0
"280","20239","Marquette Ave & 89th St",41.7336687907147,-87.558342218399,8,6,3,0,4,6,14,10,0
"281","20242","Houston Ave & 92nd St",41.728204215358,-87.5497001409531,6,12,2,1,3,8,18,11,3
"282","20243","Michigan Ave & 114th St",41.6870147946712,-87.6210522651672,1,3,0,0,1,2,4,3,0
"283","20244","Halsted St & 73rd St",41.7616398333333,-87.6440623333333,10,9,5,5,2,1,19,3,10
"284","20245","Ashland Ave & 74th St",41.759236,-87.663474,4,3,0,0,3,3,7,6,0
"285","20246.0","N Green St & W Lake St",41.89,-87.65,51,33,51,33,0,0,84,0,84
"286","20247.0","W Washington Blvd & N Peoria St",41.88,-87.65,3,4,3,4,0,0,7,0,7
"287","20248.0","N Hampden Ct & W Diversey Ave",41.93,-87.64,1,0,1,0,0,0,0,0,0
"288","20251.0","N Carpenter St & W Lake St",41.89,-87.65,1,2,1,2,0,0,3,0,3
"289","20252.0","W Oakdale Ave & N Broadway",41.94,-87.64,43,34,43,34,0,0,77,0,77
"290","20253.0","N Paulina St & Lincoln Ave",41.94,-87.67,2,5,2,5,0,0,7,0,7
"291","20254.0","W Armitage Ave & N Sheffield Ave",41.92,-87.65,8,4,8,4,0,0,12,0,12
"292","20256.0","N Sheffield Ave & W Wellington Ave",41.94,-87.65,7,6,7,6,0,0,13,0,13
"293","20257.0","N Southport Ave & W Newport Ave",41.94,-87.66,10,10,10,10,0,0,20,0,20
"294","20258.0","N Damen Ave & W Wabansia St",41.91,-87.68,1,3,1,3,0,0,4,0,4
"295","331","Halsted St & Clybourn Ave",41.909668,-87.648128,887,915,236,234,631,652,1802,1283,470
"296","514","Ridge Blvd & Howard St",42.019276,-87.68452,42,32,11,12,26,19,74,45,23
"297","515","Paulina St & Howard St",42.019159,-87.673573,110,115,25,25,75,86,225,161,50
"298","517","Clark St & Jarvis Ave",42.015963,-87.675005,67,63,13,11,52,51,130,103,24
"299","518","Conservatory Dr & Lake St",41.885502,-87.716866,37,41,26,24,11,16,78,27,50
"300","519","Wolcott Ave & Fargo Ave",42.0169628333333,-87.6777086666667,21,18,5,5,14,12,39,26,10
"301","520","Greenview Ave & Jarvis Ave",42.015962,-87.66857,177,187,56,54,118,130,364,248,110
"302","523","Eastlake Ter & Rogers Ave",42.0208872805206,-87.6650579273701,194,177,35,34,148,131,371,279,69
"303","525","Glenwood Ave & Touhy Ave",42.012701,-87.666058,100,84,13,15,85,67,184,152,28
"304","527","Western Ave & Howard St",42.0189338333333,-87.6900478333333,50,59,33,32,15,21,109,36,65
"305","528","Pulaski Rd & Lake St",41.885409,-87.726491,5,7,2,4,3,3,12,6,6
"306","530","Laramie Ave & Kinzie St",41.887832,-87.755527,6,5,2,3,4,2,11,6,5
"307","534","Karlov Ave & Madison St",41.8808536666667,-87.7279976666667,3,5,1,2,2,3,8,5,3
"308","535","Pulaski Rd & Congress Pkwy",41.8743228333333,-87.7259955,13,12,8,9,5,2,25,7,17
"309","536","Kostner Ave & Lake St",41.8859465,-87.7354291666667,3,2,2,2,1,0,5,0,4
"310","537","Kenton Ave & Madison St",41.880708,-87.741018,5,3,0,0,5,3,8,8,0
"311","540","Laramie Ave & Madison St",41.880207,-87.755337,5,3,3,1,1,1,8,2,4
"312","543","Laramie Ave & Gladys Ave",41.8758181666667,-87.7553151666667,2,1,2,0,0,0,3,0,0
"313","545","Kostner Ave & Adams St",41.877917,-87.735737,15,14,6,4,7,8,29,15,10
"314","546","Damen Ave & Pershing Rd",41.8231725,-87.6766043333333,60,56,28,28,23,23,116,46,56
"315","549","Marshfield Ave & 44th St",41.813996,-87.666589,9,10,1,1,8,9,19,17,2
"316","553","Elizabeth St & 47th St",41.80839,-87.656526,4,3,0,0,3,2,7,5,0
"317","554","Damen Ave & 51st St",41.800908,-87.674684,4,9,2,6,2,3,13,5,8
"318","556","Throop St & 52nd St",41.799659,-87.657195,0,0,0,0,0,0,0,0,0
"319","557","Seeley Ave & Garfield Blvd",41.794087,-87.675478,7,3,1,0,5,2,10,7,0
"320","559","Racine Ave & Garfield Blvd",41.794228,-87.655073,11,10,1,1,8,6,21,14,2
"321","560","Marshfield Ave & 59th St",41.786833,-87.666215,1,1,0,0,0,0,2,0,0
"322","561","Damen Ave & 59th St",41.7860738333333,-87.6741458333333,1,2,1,0,0,0,3,0,0
"323","562","Racine Ave & 61st St",41.783189,-87.654372,2,1,1,1,1,0,3,0,2
"324","567","May St & 69th St",41.768938,-87.652934,4,4,0,0,4,4,8,8,0
"325","569","Woodlawn Ave & 75th St",41.75916,-87.595751,3,1,0,0,3,1,4,4,0
"326","570","Evans Ave & 75th St",41.75849,-87.60641,5,5,0,0,4,4,10,8,0
"327","571","Vernon Ave & 75th St",41.758361,-87.614138,6,6,3,3,3,3,12,6,6
"328","572","State St & 76th St",41.756971,-87.624621,2,3,1,0,1,3,5,4,0
"329","573","State St & 79th St",41.7507961666667,-87.624448,9,6,2,2,7,1,15,8,4
"330","574","Vernon Ave & 79th St",41.75094,-87.61379,5,2,0,0,5,2,7,7,0
"331","575","Cottage Grove Ave & 78th St",41.753174,-87.605026,5,7,1,1,4,6,12,10,2
"332","576","Greenwood Ave & 79th St",41.751294,-87.597552,15,14,1,1,12,11,29,23,2
"333","577","Stony Island Ave & South Chicago Ave",41.751173,-87.585337,6,6,1,1,5,5,12,10,2
"334","579","Phillips Ave & 79th St",41.75182,-87.565211,20,19,1,1,15,14,39,29,2
"335","580","Exchange Ave & 79th St",41.751731,-87.552812,3,6,2,1,1,5,9,6,3
"336","582","Phillips Ave & 83rd St",41.744531,-87.56506,9,9,0,0,7,7,18,14,0
"337","583","Stony Island Ave & 82nd St",41.746559,-87.586005,26,24,17,17,9,7,50,16,34
"338","584","Ellis Ave & 83rd St",41.744123,-87.599034,10,9,0,0,10,9,19,19,0
"339","585","Cottage Grove Ave & 83rd St",41.743441,-87.604836,13,16,4,3,7,11,29,18,7
"340","586","MLK Jr Dr & 83rd St",41.743116,-87.6148,2,3,0,0,2,3,5,5,0
"341","587","Wabash Ave & 83rd St",41.743316,-87.622849,8,7,0,0,6,5,15,11,0
"342","588","South Chicago Ave & 83rd St",41.743921,-87.575225,0,0,0,0,0,0,0,0,0
"343","590","Kilbourn Ave & Irving Park Rd",41.953733,-87.740569,21,24,10,9,10,15,45,25,19
"344","592","Knox Ave & Montrose Ave",41.960631,-87.745359,36,38,17,15,16,17,74,33,32
"345","593","Halsted St & 59th St",41.787539,-87.644874,2,1,0,0,2,1,3,3,0
"346","594","Western Blvd & 48th Pl",41.805668,-87.6833186666667,19,29,17,24,1,5,48,6,41
"347","595","Wabash Ave & 87th St",41.736646,-87.622634,26,17,7,4,14,11,43,25,11
"348","596","Benson Ave & Church St",42.048214,-87.683485,243,283,59,58,164,202,526,366,117
"349","598","Elmwood Ave & Austin St",42.0257631666667,-87.6840986666667,40,43,32,33,8,10,83,18,65
"350","599","Valli Produce - Evanston Plaza",42.039742,-87.699413,67,67,24,24,38,37,134,75,48
"351","600","Dodge Ave & Church St",42.048308,-87.698224,36,34,6,12,29,21,70,50,18
"352","604","Sheridan Rd & Noyes St (NU)",42.058239,-87.677432,251,250,48,52,188,182,501,370,100
"353","605","University Library (NU)",42.052939,-87.673447,164,161,21,21,130,127,325,257,42
"354","620","Orleans St & Chestnut St (NEXT Apts)",41.898203,-87.637536,465,462,95,94,347,346,927,693,189
"355","623","Michigan Ave & 8th St",41.872773,-87.623981,886,862,152,150,581,543,1748,1124,302
"356","624","Dearborn St & Van Buren St",41.876268,-87.629155,421,404,62,64,311,299,825,610,126
"357","631","Malcolm X College Vaccination Site",41.877618,-87.673895,83,66,25,18,51,45,149,96,43
"358","632","Clark St & Newport St",41.94454,-87.654678,906,917,186,188,670,686,1823,1356,374
"359","636","Orleans St & Hubbard St",41.8897803333333,-87.636649,513,499,130,131,359,351,1012,710,261
"360","637","Wood St & Chicago Ave",41.8956343333333,-87.6721708333333,323,336,74,77,243,254,659,497,151
"361","638","Clinton St & Jackson Blvd",41.8781160301053,-87.6398384571075,581,499,154,131,390,344,1080,734,285
"362","639","Lakefront Trail & Wilson Ave",41.965845,-87.645361,524,516,61,61,386,371,1040,757,122
"363","642","Latrobe Ave & Chicago Ave",41.8947208333333,-87.7568665,12,5,5,0,5,3,17,8,0
"364","643","Smith Park",41.892048,-87.689397,106,110,37,33,69,77,216,146,70
"365","644","Western Ave & Fillmore St",41.868638,-87.686247,159,145,80,80,69,59,304,128,160
"366","646","State St & 54th St",41.796642,-87.625923,10,11,3,4,6,5,21,11,7
"367","647","Elizabeth St & 59th St",41.786691,-87.655859,1,1,0,0,1,1,2,2,0
"368","649","Stewart Ave & 63rd St",41.779835,-87.634774,1,1,0,0,1,1,2,2,0
"369","650","Eggleston Ave & 69th St",41.768898,-87.635876,6,7,0,0,6,6,13,12,0
"370","651","Michigan Ave & 71st St",41.7652865,-87.6217383333333,7,10,5,6,1,4,17,5,11
"371","652","Rhodes Ave & 71st St",41.766,-87.611726,3,1,0,0,3,1,4,4,0
"372","653","Cornell Dr & Hayes Dr",41.780563,-87.5852008333333,17,16,6,6,9,3,33,12,12
"373","654","Racine Ave & Washington Blvd",41.8830788333333,-87.6570221666667,206,223,35,32,167,185,429,352,67
"374","655","Hoyne Ave & Balmoral Ave",41.979851,-87.681932,94,104,44,45,46,50,198,96,89
"375","657","Wood St & Augusta Blvd",41.899181,-87.6722,269,257,80,67,184,185,526,369,147
"376","658","Leavitt St & Division St",41.902997,-87.683825,237,205,72,58,156,136,442,292,130
"377","660","Sheridan Rd & Columbia Ave",42.004654,-87.6614746666667,232,223,47,50,172,165,455,337,97
"378","661","Evanston Civic Center",42.057044,-87.686554,48,38,11,14,32,24,86,56,25
"379","662","Dodge Ave & Mulford St",42.023463,-87.699595,33,31,5,2,28,27,64,55,7
"380","E002","Chicago Ave & Washington St",42.032562,-87.679101,231,242,58,56,145,149,473,294,114
"381","E006","Central St Metra",42.063598,-87.69873,60,48,9,9,43,35,108,78,18
"382","E007","Central St & Girard Ave",42.064313,-87.686152,59,73,11,9,41,55,132,96,20
"383","E008","Chicago Ave & Sheridan Rd",42.050491,-87.677821,160,168,25,24,116,124,328,240,49
"384","E011","Dodge Ave & Main St",42.0346318516159,-87.6991876959801,13,14,3,3,8,9,27,17,6
"385","E014","Lincolnwood Dr & Central St",42.064854,-87.715297,47,53,1,1,44,49,100,93,2
"386","Hubbard Bike-checking (LBS-WH-TEST)","Base - 2132 W Hubbard Warehouse",41.8899743333333,-87.6802471666667,1,13,1,4,0,0,14,0,5
"387","KA1503000002","South Shore Dr & 71st St",41.7664483333333,-87.5656588333333,134,123,35,35,85,76,257,161,70
"388","KA1503000003","Cottage Grove Ave & 71st St",41.76571903697,-87.604959713,14,12,1,1,11,7,26,18,2
"389","KA1503000004","Lake Park Ave & 35th St",41.831195,-87.6086908333333,192,199,37,34,118,120,391,238,71
"390","KA1503000005","Wentworth Ave & 35th St",41.830777,-87.632504,30,33,5,5,24,26,63,50,10
"391","KA1503000007","Cornell Ave & Hyde Park Blvd",41.802406,-87.586924,442,395,56,53,359,311,837,670,109
"392","KA1503000009","Princeton Ave & 47th St",41.80931770924,-87.633449288,16,12,5,1,11,11,28,22,6
"393","KA1503000010","Halsted St & 51st St",41.8017391666667,-87.645237,2,1,2,0,0,0,3,0,0
"394","KA1503000011","Halsted St & 56th St",41.79292964599,-87.6449900565,3,2,0,0,3,2,5,5,0
"395","KA1503000012","Clark St & Lake St",41.88602082773,-87.6308760584,754,734,176,175,530,501,1488,1031,351
"396","KA1503000013","Princeton Ave & Garfield Blvd",41.794982,-87.633124,15,9,2,2,13,7,24,20,4
"397","KA1503000014","Ellis Ave & 60th St",41.785097,-87.601073,770,735,87,85,638,608,1505,1246,172
"398","KA1503000015","Wabash Ave & Adams St",41.87947235235,-87.6256886059,612,600,150,149,390,368,1212,758,299
"399","KA1503000018","Jeffery Blvd & 71st St",41.76663823695,-87.5764501141,24,34,6,6,15,22,58,37,12
"400","KA1503000019","Stony Island Ave & 75th St",41.7586696704,-87.586882871,21,14,5,5,11,6,35,17,10
"401","KA1503000020","South Shore Dr & 74th St",41.76218896038,-87.55927465,32,33,4,6,26,24,65,50,10
"402","KA1503000021","Stony Island Ave & 64th St",41.778881,-87.586647,27,29,8,8,14,17,56,31,16
"403","KA1503000022","Clark St & Montrose Ave",41.961588,-87.666036,282,230,47,43,226,180,512,406,90
"404","KA1503000023","Stony Island Ave & 67th St",41.77345849948,-87.5853397391,28,17,1,1,22,15,45,37,2
"405","KA1503000024","Yates Blvd & 75th St",41.758768,-87.56644,20,22,0,0,18,21,42,39,0
"406","KA1503000025","Wentworth Ave & 63rd St",41.7800863333333,-87.6297866666667,11,7,7,7,4,0,18,0,14
"407","KA1503000027","Prairie Ave & 43rd St",41.816659,-87.619412,71,84,7,7,60,73,155,133,14
"408","KA1503000028","Jeffery Blvd & 76th St",41.75712,-87.575839,15,12,0,0,11,10,27,21,0
"409","KA1503000029","South Shore Dr & 67th St",41.773643,-87.567514,80,73,7,8,68,53,153,121,15
"410","KA1503000030","Jeffery Blvd & 67th St",41.77351755125,-87.5771428255,57,41,8,3,36,28,98,64,11
"411","KA1503000031","Cottage Grove Ave & 67th St",41.77372095205,-87.60563486,8,7,1,1,7,5,15,12,2
"412","KA1503000032","Union Ave & Root St",41.8191506666667,-87.643278,13,17,6,7,7,9,30,16,13
"413","KA1503000033","Eberhart Ave & 61st St",41.78414169317,-87.6133078304,13,23,0,0,13,22,36,35,0
"414","KA1503000034","LaSalle St & Adams St",41.87934437346,-87.6319852213,270,245,60,55,190,173,515,363,115
"415","KA1503000038","Shields Ave & 31st St",41.8384868333333,-87.6353881666667,155,149,21,25,125,121,304,246,46
"416","KA1503000040","Loomis St & Archer Ave",41.84163253965,-87.6574349533,69,47,9,8,59,38,116,97,17
"417","KA1503000041","McClurg Ct & Erie St",41.894518,-87.6181393333333,1054,1159,215,219,796,888,2213,1684,434
"418","KA1503000043","Kingsbury St & Kinzie St",41.88917683258,-87.6385057718,1476,1440,351,316,1081,1093,2916,2174,667
"419","KA1503000044","Rush St & Hubbard St",41.890173,-87.626185,493,500,85,81,358,345,993,703,166
"420","KA1503000045","Stony Island Ave & 71st St",41.766493,-87.586461,38,40,12,12,22,28,78,50,24
"421","KA1503000046","Dorchester Ave & 63rd St",41.7804056457,-87.5914159893,33,32,3,3,30,28,65,58,6
"422","KA1503000047","Perry Ave & 69th St",41.76929308995,-87.6281959291,8,8,1,2,7,6,16,13,3
"423","KA1503000049","Rainbow Beach",41.75787144829,-87.54938625,20,20,3,3,17,16,40,33,6
"424","KA1503000051","Halsted St & 47th Pl",41.8081723333333,-87.6455993333333,24,22,12,12,12,9,46,21,24
"425","KA1503000052","Ellis Ave & 53rd St",41.7995888333333,-87.6010303333333,369,331,73,66,275,251,700,526,139
"426","KA1503000053","MLK Jr Dr & 63rd St",41.78008063659,-87.6159428567,6,10,0,0,5,9,16,14,0
"427","KA1503000054","Cottage Grove Ave & 63rd St",41.7806009452142,-87.6058360934258,31,30,5,5,22,22,61,44,10
"428","KA1503000055","Halsted & 63rd - Kennedy-King Vaccination Site",41.77938114228,-87.6446208145,8,9,0,0,8,6,17,14,0
"429","KA1503000059","Lake Park Ave & 53rd St",41.79949429373,-87.5864498959,330,352,44,43,258,276,682,534,87
"430","KA1503000064","Dusable Harbor",41.886976,-87.612813,754,682,84,72,448,455,1436,903,156
"431","KA1503000065","Woodlawn Ave & Lake Park Ave",41.81409271048,-87.5970051479,120,124,21,23,95,98,244,193,44
"432","KA1503000066","Wood St & 35th St",41.83010465416,-87.6702983089,68,65,20,18,44,42,133,86,38
"433","KA1503000068","Leavitt St & Archer Ave",41.82879201994,-87.6806044594,54,49,12,10,40,39,103,79,22
"434","KA1503000069","Dorchester Ave & 49th St",41.805772,-87.592464,89,84,18,18,60,57,173,117,36
"435","KA1503000070","Harper Ave & 59th St",41.78794281287,-87.5883151702,182,165,17,13,158,137,347,295,30
"436","KA1503000071","University Ave & 57th St",41.791478,-87.599861,671,703,69,66,566,594,1374,1160,135
"437","KA1503000072","Wacker Dr & Washington St",41.883132,-87.637321,493,431,152,135,303,262,924,565,287
"438","KA1503000073","MLK Jr Dr & 56th St",41.79342945658,-87.6158532619,26,28,13,13,12,13,54,25,26
"439","KA1503000074","Museum of Science and Industry",41.79172820953,-87.583945009,237,243,44,41,150,153,480,303,85
"440","KA1503000075","DuSable Museum",41.791568,-87.607852,31,33,6,7,18,22,64,40,13
"441","KA1504000076","Ellis Ave & 55th St",41.79430062054,-87.6014497734,626,628,66,65,533,542,1254,1075,131
"442","KA1504000078","Lincoln Ave & Winona St",41.97491129677,-87.6925025594,154,143,42,39,107,99,297,206,81
"443","KA1504000079","Larrabee St & Division St",41.9035401666667,-87.6433268333333,549,537,124,121,406,400,1086,806,245
"444","KA1504000080","Washtenaw Ave & Lawrence Ave",41.968987,-87.696027,146,153,48,53,88,87,299,175,101
"445","KA1504000082","Kedzie Ave & Harrison St",41.8736,-87.704871,7,10,0,0,6,9,17,15,0
"446","KA1504000086","Kedzie Ave & 24th St",41.848191,-87.705414,6,9,1,2,4,5,15,9,3
"447","KA1504000090","St. Louis Ave & Fullerton Ave",41.9248155968119,-87.714495062828,132,140,33,33,93,103,272,196,66
"448","KA1504000091","Hoyne Ave & 47th St",41.808219,-87.677197,8,10,4,4,3,5,18,8,8
"449","KA1504000093","Rockwell St & Eastwood Ave",41.965797,-87.6936245,184,177,70,71,112,104,361,216,141
"450","KA1504000096","Sawyer Ave & Irving Park Rd",41.95358617895,-87.7093107999,56,54,16,18,34,33,110,67,34
"451","KA1504000097","Drake Ave & Montrose Ave",41.96115407569,-87.7165690733,56,63,9,10,44,47,119,91,19
"452","KA150400009X","Kimball Ave & Belmont Ave",41.939398,-87.711561,77,74,25,24,44,46,151,90,49
"453","KA1504000101","Ogden Ave & Roosevelt Rd",41.86650148316,-87.68469707,50,47,8,9,39,36,97,75,17
"454","KA1504000102","Fairfield Ave & Roosevelt Rd",41.8666835,-87.6945353333333,35,31,19,19,15,11,66,26,38
"455","KA1504000103","Western Ave & Walton St",41.898418,-87.686596,378,297,87,72,276,214,675,490,159
"456","KA1504000104","Paulina St & Flournoy St",41.87295,-87.66913,683,674,129,125,544,543,1357,1087,254
"457","KA1504000106","Kedzie Ave & Lake St",41.88460328501,-87.7063037436,43,52,25,24,17,24,95,41,49
"458","KA1504000109","Washtenaw Ave & Ogden Ave",41.8619304927826,-87.6934504508972,73,82,11,10,60,71,155,131,21
"459","KA1504000110","Millard Ave & 26th St",41.8446933333333,-87.7158311666667,19,23,5,5,14,16,42,30,10
"460","KA1504000113","Sacramento Blvd & Franklin Blvd",41.8904687924386,-87.7026075124741,20,17,6,5,14,12,37,26,11
"461","KA1504000114","Kedzie Ave & Chicago Ave",41.89546530305,-87.7061278837,79,64,36,36,38,25,143,63,72
"462","KA1504000116","Larrabee St & Oak St",41.9002913333333,-87.6429771666667,363,319,67,68,290,249,682,539,135
"463","KA1504000117","Halsted St & North Branch St",41.89936843921,-87.6484798752,93,88,13,12,75,72,181,147,25
"464","KA1504000126","Kedzie Ave & Leland Ave",41.96668636205,-87.7080519806,67,65,17,16,48,46,132,94,33
"465","KA1504000127","Manor Ave & Leland Ave",41.965875,-87.700825,114,103,32,30,78,65,217,143,62
"466","KA1504000128","Kedzie Ave & Foster Ave",41.9756768333333,-87.7092748333333,67,72,13,13,51,58,139,109,26
"467","KA1504000129","Western Ave & Granville Ave",41.9941463333333,-87.6894893333333,84,113,42,43,30,61,197,91,85
"468","KA1504000130","Maplewood Ave & Peterson Ave",41.99023602867,-87.6933696402,20,24,9,9,9,10,44,19,18
"469","KA1504000133","Rush St & Cedar St",41.90230870122,-87.627690528,957,969,243,243,656,660,1926,1316,486
"470","KA1504000134","Ritchie Ct & Banks St",41.906866,-87.626217,666,607,158,153,480,432,1273,912,311
"471","KA1504000135","Wells St & Elm St",41.903222,-87.634324,1660,1609,410,399,1205,1167,3269,2372,809
"472","KA1504000139","Monticello Ave & Irving Park Rd",41.9539398333333,-87.7190428333333,89,81,31,31,53,46,170,99,62
"473","KA1504000140","Winchester Ave & Elston Ave",41.92409085038,-87.6764600747,155,156,29,28,118,120,311,238,57
"474","KA1504000141","Pulaski Rd & Eddy St (Temp)",41.946264,-87.731023,32,34,7,6,24,27,66,51,13
"475","KA1504000142","Drake Ave & Addison St",41.947326,-87.717582,34,36,10,10,20,20,70,40,20
"476","KA1504000143","Leavitt St & Addison St",41.946534,-87.6834358333333,83,75,19,15,57,54,158,111,34
"477","KA1504000146","Clark St & Berwyn Ave",41.9780228333333,-87.6680296666667,499,514,123,125,355,372,1013,727,248
"478","KA1504000147","Winchester (Ravenswood) Ave & Balmoral Ave",41.979757,-87.6776545,67,72,15,14,52,55,139,107,29
"479","KA1504000148","Clark St & Elmdale Ave",41.9908604481256,-87.6697236299515,152,167,39,39,99,120,319,219,78
"480","KA1504000149","Damen Ave & Foster Ave",41.97561480459,-87.6794590387,189,188,40,43,136,132,377,268,83
"481","KA1504000151","Clark St & Bryn Mawr Ave",41.983593,-87.669154,270,268,44,44,226,216,538,442,88
"482","KA1504000152","Lakefront Trail & Bryn Mawr Ave",41.98403669612,-87.6523104689,820,805,94,92,624,636,1625,1260,186
"483","KA1504000155","2112 W Peterson Ave",41.991178,-87.683593,55,53,16,16,36,34,108,70,32
"484","KA1504000156","Clark St & Schreiber Ave",41.9992573333333,-87.6714441666667,141,125,25,22,101,90,266,191,47
"485","KA1504000158","Oakley Ave & Irving Park Rd",41.95434085219,-87.6860796243,122,137,23,19,93,111,259,204,42
"486","KA1504000159","Sheridan Rd & Greenleaf Ave",42.01058656284,-87.6624120948,143,120,34,28,95,81,263,176,62
"487","KA1504000160","Francisco Ave & Foster Ave",41.97563272521,-87.7014194389,103,97,26,24,73,69,200,142,50
"488","KA1504000161","St. Louis Ave & Balmoral Ave",41.98039423475,-87.7161149615,38,27,3,2,28,19,65,47,5
"489","KA1504000162","Clark St & Lunt Ave",42.009074,-87.67419,122,121,48,49,74,69,243,143,97
"490","KA1504000164","Keystone Ave & Montrose Ave",41.96110801623,-87.7289701012,34,33,5,4,24,25,67,49,9
"491","KA1504000167","Kedzie Ave & Bryn Mawr Ave",41.98239708485,-87.7089225202,64,53,13,12,33,29,117,62,25
"492","KA1504000168","Western & 28th - Velasquez Institute Vaccination Site",41.8415051666667,-87.6851648333333,20,8,8,2,11,6,28,17,10
"493","KA1504000171","Marine Dr & Ainslie St",41.9716,-87.650154,428,423,76,73,316,318,851,634,149
"494","KA1504000175","Glenwood Ave & Morse Ave",42.007972,-87.665502,222,214,64,65,135,137,436,272,129
"495","KA17018054","Damen Ave & Walnut (Lake) St",41.885951,-87.677009,128,140,40,33,87,105,268,192,73
"496","KA17018068","Leavitt St & Belmont Ave",41.939354,-87.683282,162,163,49,46,111,115,325,226,95
"497","KA1706005007","Delano Ct & Roosevelt Rd",41.867491,-87.63219,295,297,72,70,199,193,592,392,142
"498","KA1706005015","Kildare Ave & Montrose Ave",41.9610248333333,-87.7356751666667,38,34,5,5,28,25,72,53,10
"499","KP1705001026","LaSalle Dr & Huron St",41.894877,-87.632326,752,757,203,202,507,495,1509,1002,405
"500","LF-005","Lake Shore Dr & North Blvd",41.911722,-87.626804,1319,1340,173,165,978,976,2659,1954,338
"501","LP-","Lincoln Park Conservatory",41.9239313113662,-87.6358245313168,538,534,88,85,361,360,1072,721,173
"502","RN-","Franklin St & Illinois St",41.891053,-87.6354006666667,880,888,242,238,622,628,1768,1250,480
"503","RP-001","Warren Park West",42.001785,-87.688829,80,82,21,20,52,55,162,107,41
"504","RP-002","Warren Park East",42.00454962194,-87.6806661451,30,35,1,2,28,29,65,57,3
"505","RP-004","Oakley Ave & Touhy Ave",42.012342,-87.688243,36,41,11,13,23,25,77,48,24
"506","RP-005","Western Ave & Lunt Ave",42.0085943972,-87.6904922389,86,79,25,22,59,54,165,113,47
"507","RP-006","Ridge Blvd & Touhy Ave",42.01213227742,-87.6829126443,37,27,16,11,19,16,64,35,27
"508","RP-007","Clark St & Touhy Ave",42.01256011541,-87.6743671152,55,52,15,14,40,36,107,76,29
"509","RP-008","Clark St & Columbia Ave",42.0044655,-87.6724023333333,134,119,49,50,81,62,253,143,99
"510","RP-009","Sheridan Rd & Loyola Ave",42.001044,-87.661198,326,330,78,78,222,223,656,445,156
"511","SL-005","Indiana Ave & Roosevelt Rd",41.8678423333333,-87.6230255,1612,1525,288,263,1081,1031,3137,2112,551
"512","SL-006","Wells St & 19th St",41.856802,-87.633879,124,153,21,19,69,94,277,163,40
"513","SL-007","State St & Harrison St",41.874053,-87.627716,420,413,101,90,271,264,833,535,191
"514","SL-008","Federal St & Polk St",41.872078,-87.629544,976,967,210,212,711,701,1943,1412,422
"515","SL-009","Clark St & 9th St (AMLI)",41.870816,-87.631246,362,333,82,82,258,228,695,486,164
"516","SL-010","Financial Pl & Ida B Wells Dr",41.8750513333333,-87.6330901666667,342,319,93,93,238,212,661,450,186
"517","SL-011","Wells St & Polk St",41.872596,-87.633502,593,590,159,160,408,399,1183,807,319
"518","SL-012","Wabash Ave & 16th St",41.860384,-87.625813,505,495,86,86,415,390,1000,805,172
"519","SL-013","State St & 19th St",41.8565245,-87.6275103333333,154,164,27,27,111,122,318,233,54
"520","TA1305000001","Wabash Ave & Cermak Rd",41.8526141666667,-87.6265541666667,123,129,33,33,73,83,252,156,66
"521","TA1305000002","Wabash Ave & Roosevelt Rd",41.867227,-87.625961,1214,1240,201,202,907,927,2454,1834,403
"522","TA1305000003","Fairbanks Ct & Grand Ave",41.8918473721099,-87.6205801963806,1169,1183,247,247,831,820,2352,1651,494
"523","TA1305000004","McCormick Place",41.8513751729,-87.6188346489,97,77,12,10,71,58,174,129,22
"524","TA1305000005","Dearborn St & Adams St",41.8790988333333,-87.6287911666667,413,388,94,89,299,286,801,585,183
"525","TA1305000006","Dearborn St & Monroe St",41.8807745,-87.6298676666667,1055,1026,188,187,780,764,2081,1544,375
"526","TA1305000009","Clark St & Ida B Wells Dr",41.8759326655,-87.6305845355,371,364,49,49,301,286,735,587,98
"527","TA1305000010","Michigan Ave & Ida B Wells Dr",41.876243,-87.624426,433,388,85,70,277,235,821,512,155
"528","TA1305000011","Michigan Ave & Lake St",41.886024,-87.624117,1239,1262,244,240,763,808,2501,1571,484
"529","TA1305000014","Clark St & Wrightwood Ave",41.929546,-87.643118,1122,1095,260,255,821,793,2217,1614,515
"530","TA1305000017","Halsted St & Roosevelt Rd",41.8673555,-87.648597,204,180,38,28,163,142,384,305,66
"531","TA1305000020","Ogden Ave & Chicago Ave",41.896362458,-87.6540612729,453,464,121,119,321,327,917,648,240
"532","TA1305000022","Orleans St & Merchandise Mart Plaza",41.888243,-87.63639,775,639,147,140,611,485,1414,1096,287
"533","TA1305000025","Franklin St & Jackson Blvd",41.8777079559,-87.6353211408,668,625,169,167,462,433,1293,895,336
"534","TA1305000029","State St & Randolph St",41.8846305,-87.6281006666667,940,938,204,204,625,600,1878,1225,408
"535","TA1305000030","Clark St & Randolph St",41.884576228,-87.63188991,732,733,162,157,515,506,1465,1021,319
"536","TA1305000032","Clinton St & Madison St",41.882242,-87.641066,1001,996,218,217,738,743,1997,1481,435
"537","TA1305000034","Honore St & Division St",41.903119,-87.673935,536,561,130,129,376,411,1097,787,259
"538","TA1305000035","State St & Van Buren St",41.877181,-87.627844,433,388,64,63,323,285,821,608,127
"539","TA1305000037","Paulina Ave & North Ave",41.910337,-87.670072,540,547,142,140,387,398,1087,785,282
"540","TA1305000039","Marshfield Ave & Cortland St",41.916017,-87.668879,409,416,112,106,288,290,825,578,218
"541","TA1305000041","Damen Ave & Pierce Ave",41.9093960065,-87.6776919292,782,860,218,222,564,592,1642,1156,440
"542","TA1306000002","Morgan Ave & 14th Pl",41.862378,-87.651062,198,192,29,28,169,162,390,331,57
"543","TA1306000003","Desplaines St & Kinzie St",41.888716036,-87.6444478533,1200,1151,295,286,870,827,2351,1697,581
"544","TA1306000006","Orleans St & Elm St",41.902924,-87.637715,231,194,35,38,184,143,425,327,73
"545","TA1306000007","Larrabee St & Menomonee St",41.91468,-87.64332,217,205,42,37,169,157,422,326,79
"546","TA1306000008","Larrabee St & North Ave",41.9101066666667,-87.6434833333333,346,319,102,98,239,220,665,459,200
"547","TA1306000009","Larrabee St & Kingsbury St",41.897764,-87.642884,714,644,175,159,527,482,1358,1009,334
"548","TA1306000010","Daley Center Plaza",41.884241,-87.629634,914,855,172,163,695,664,1769,1359,335
"549","TA1306000011","Wells St & Walton St",41.89993001,-87.63443007,502,373,82,66,395,286,875,681,148
"550","TA1306000012","Wells St & Huron St",41.894722,-87.634362,1471,1330,423,370,1009,932,2801,1941,793
"551","TA1306000013","New St & Illinois St",41.8908470406238,-87.6186168193817,1053,1093,220,218,711,746,2146,1457,438
"552","TA1306000014","Wilton Ave & Diversey Pkwy",41.932418,-87.652705,861,838,176,172,662,650,1699,1312,348
"553","TA1306000015","Morgan St & Lake St",41.8854833079,-87.6523048564,708,830,226,228,431,560,1538,991,454
"554","TA1306000016","Sheffield Ave & Fullerton Ave",41.9256018819,-87.6537080423,524,475,107,107,400,351,999,751,214
"555","TA1306000025","Racine Ave & Congress Pkwy",41.87464,-87.65703,234,222,50,41,177,176,456,353,91
"556","TA1306000026","Racine Ave & Fullerton Ave",41.92556258,-87.65840426,650,647,98,95,536,538,1297,1074,193
"557","TA1306000029","Lake Shore Dr & Ohio St",41.89257,-87.614492,876,882,156,152,587,621,1758,1208,308
"558","TA1306000032","Sheffield Ave & Willow St",41.913688,-87.652855,650,653,111,109,526,532,1303,1058,220
"559","TA1307000001","Greenview Ave & Fullerton Ave",41.92533,-87.6658,602,633,150,156,420,446,1235,866,306
"560","TA1307000005","Indiana Ave & 26th St",41.845687,-87.622481,245,228,52,46,193,182,473,375,98
"561","TA1307000006","Southport Ave & Wellington Ave",41.9355766666667,-87.663742,476,494,99,93,357,393,970,750,192
"562","TA1307000038","Sedgwick St & North Ave",41.911386,-87.638677,771,764,151,152,588,590,1535,1178,303
"563","TA1307000039","Clark St & Elm St",41.902973,-87.63128,1935,1924,396,396,1478,1478,3859,2956,792
"564","TA1307000041","Lake Shore Dr & Wellington Ave",41.9366884494997,-87.6368290185928,896,1041,142,148,690,815,1937,1505,290
"565","TA1307000044","Clinton St & 18th St",41.85795,-87.640826,188,197,30,30,155,155,385,310,60
"566","TA1307000048","Fort Dearborn Dr & 31st St",41.838512,-87.6082463333333,594,588,40,38,421,428,1182,849,78
"567","TA1307000052","Sheffield Ave & Wellington Ave",41.9363013333333,-87.6527083333333,884,895,155,153,707,726,1779,1433,308
"568","TA1307000061","State St & Pearson St",41.897448,-87.628722,480,433,116,110,339,286,913,625,226
"569","TA1307000062","Sedgwick St & Huron St",41.894666,-87.638437,597,554,127,125,451,419,1151,870,252
"570","TA1307000064","Lincoln Ave & Diversey Pkwy",41.932225,-87.658617,701,707,150,146,529,545,1408,1074,296
"571","TA1307000066","Damen Ave & Coulter St",41.8492,-87.67564,32,33,12,11,18,20,65,38,23
"572","TA1307000070","Damen Ave & Thomas St (Augusta Blvd)",41.901315,-87.677409,375,350,98,74,269,269,725,538,172
"573","TA1307000107","Sheridan Rd & Montrose Ave",41.96167,-87.65464,686,697,168,169,492,493,1383,985,337
"574","TA1307000111","Franklin St & Lake St",41.885837,-87.6355,821,769,219,216,563,504,1590,1067,435
"575","TA1307000113","Southport Ave & Wrightwood Ave",41.928773,-87.663913,448,458,107,110,327,333,906,660,217
"576","TA1307000115","Clybourn Ave & Division St",41.904613,-87.640552,400,393,74,76,313,300,793,613,150
"577","TA1307000117","Wabash Ave & Grand Ave",41.8914606666667,-87.6267585,1384,1519,314,312,941,1038,2903,1979,626
"578","TA1307000119","Clarendon Ave & Leland Ave",41.967968,-87.650001,310,304,61,60,239,237,614,476,121
"579","TA1307000120","Green St & Madison St",41.881892,-87.648789,975,1076,244,252,690,780,2051,1470,496
"580","TA1307000121","Halsted St & Polk St",41.87184,-87.64664,428,456,79,80,337,369,884,706,159
"581","TA1307000124","Michigan Ave & 14th St",41.864059,-87.623727,670,649,146,144,490,474,1319,964,290
"582","TA1307000126","Sheffield Ave & Waveland Ave",41.949399,-87.654529,843,793,149,134,637,611,1636,1248,283
"583","TA1307000127","Clark St & Grace St",41.95078,-87.659172,655,615,130,125,494,455,1270,949,255
"584","TA1307000128","Dearborn Pkwy & Delaware Pl",41.898969,-87.629912,1119,1112,265,263,806,808,2231,1614,528
"585","TA1307000129","State St & 35th St",41.831036,-87.626798,169,185,33,32,126,146,354,272,65
"586","TA1307000130","Morgan St & Polk St",41.871737,-87.65103,429,400,69,66,354,323,829,677,135
"587","TA1307000131","Wabash Ave & Wacker Pl",41.886875,-87.62603,722,713,140,142,432,402,1435,834,282
"588","TA1307000134","Wilton Ave & Belmont Ave",41.94018,-87.65304,1004,1064,188,194,771,838,2068,1609,382
"589","TA1307000136","Clark St & Wellington Ave",41.9364968219,-87.6475386582,1033,1019,185,186,806,808,2052,1614,371
"590","TA1307000138","Lincoln Ave & Roscoe St",41.94334,-87.67097,502,541,123,123,349,399,1043,748,246
"591","TA1307000139","MLK Jr Dr & 29th St",41.842052,-87.617,457,431,65,65,368,341,888,709,130
"592","TA1307000140","Western Ave & Leland Ave",41.9665486666667,-87.6884358333333,311,301,93,95,200,195,612,395,188
"593","TA1307000142","Clark St & Drummond Pl",41.931248,-87.644336,996,1026,179,183,793,815,2022,1608,362
"594","TA1307000143","Sedgwick St & Schiller St",41.907626,-87.638566,249,181,44,27,196,140,430,336,71
"595","TA1307000144","Wolcott (Ravenswood) Ave & Montrose Ave",41.9614556666667,-87.6762143333333,253,251,66,67,166,172,504,338,133
"596","TA1307000149","Ravenswood Ave & Irving Park Rd",41.9546565,-87.6738863333333,305,310,76,70,219,226,615,445,146
"597","TA1307000150","Pine Grove Ave & Waveland Ave",41.9494727408833,-87.6464527845383,904,906,137,138,724,725,1810,1449,275
"598","TA1307000151","Wells St & Hubbard St",41.889906,-87.634266,1157,1138,262,253,842,838,2295,1680,515
"599","TA1307000153","Emerald Ave & 28th St",41.8435683333333,-87.6453858333333,117,130,13,13,99,110,247,209,26
"600","TA1307000156","Lincoln Ave & Sunnyside Ave",41.963004,-87.684781,268,258,61,57,197,197,526,394,118
"601","TA1307000158","Damen Ave & Leland Ave",41.9671095,-87.6790666666667,278,272,71,70,198,194,550,392,141
"602","TA1307000159","Paulina St & 18th St",41.857901,-87.668745,205,229,49,50,140,162,434,302,99
"603","TA1307000160","Prairie Ave & Garfield Blvd",41.794853,-87.618691,51,26,5,4,39,19,77,58,9
"604","TA1307000161","Halsted St & 37th St",41.827059,-87.64572,25,28,2,6,22,21,53,43,8
"605","TA1307000163","Clifton Ave & Armitage Ave",41.918216,-87.656936,525,556,84,84,428,455,1081,883,168
"606","TA1307000164","Woodlawn Ave & 55th St",41.795264,-87.596471,351,355,35,35,294,299,706,593,70
"607","TA1307000166","Halsted St & Willow St",41.913865,-87.648755,491,478,125,122,350,340,969,690,247
"608","TA1308000001","Theater on the Lake",41.926277,-87.630834,1488,1577,183,181,1113,1162,3065,2275,364
"609","TA1308000002","Greenwood Ave & 47th St",41.809835,-87.599383,133,112,15,16,101,86,245,187,31
"610","TA1308000005","Leavitt St & North Ave",41.910509366664,-87.6823890209198,366,337,78,77,271,250,703,521,155
"611","TA1308000006","Damen Ave & Grand Ave",41.8914103333333,-87.676928,256,236,62,49,194,181,492,375,111
"612","TA1308000007","MLK Jr Dr & 47th St",41.809851,-87.616279,50,39,17,16,22,18,89,40,33
"613","TA1308000009","Shore Dr & 55th St",41.7952296666667,-87.5808276666667,684,692,106,103,488,482,1376,970,209
"614","TA1308000012","Montrose Harbor",41.963982,-87.638181,740,689,49,41,561,527,1429,1088,90
"615","TA1308000013","Halsted St & Archer Ave",41.847203,-87.646795,67,87,10,9,56,74,154,130,19
"616","TA1308000014","Normal Ave & Archer Ave",41.849527,-87.640591,55,34,6,5,48,28,89,76,11
"617","TA1308000019","Racine Ave & Belmont Ave",41.939743,-87.658865,570,565,124,133,425,412,1135,837,257
"618","TA1308000021","Winthrop Ave & Lawrence Ave",41.968812,-87.657659,298,289,77,77,206,200,587,406,154
"619","TA1308000022","Pine Grove Ave & Irving Park Rd",41.954383,-87.648043,719,680,116,109,564,526,1399,1090,225
"620","TA1308000023","Cottage Grove Ave & 43rd St",41.816499,-87.606582,54,57,12,12,39,40,111,79,24
"621","TA1308000026","Wentworth Ave & 24th St (Temp)",41.8500836934758,-87.6321405172348,116,131,16,16,83,108,247,191,32
"622","TA1308000029","Stetson Ave & South Water St",41.886835,-87.62232,531,491,158,158,333,275,1022,608,316
"623","TA1308000031","Logan Blvd & Elston Ave",41.9294441666667,-87.6842051666667,300,335,96,97,193,218,635,411,193
"624","TA1308000035","Lake Park Ave & 47th St",41.809443,-87.591875,168,172,26,29,111,117,340,228,55
"625","TA1308000036","Indiana Ave & 31st St",41.838842,-87.621857,112,111,22,18,87,83,223,170,40
"626","TA1308000038","Cottage Grove Ave & Oakwood Blvd",41.822985,-87.6071,110,108,39,37,54,56,218,110,76
"627","TA1308000043","Halsted St & 35th St",41.830677,-87.6471178333333,60,62,13,13,44,45,122,89,26
"628","TA1308000045","Wallace St & 35th St",41.8305923333333,-87.6412981666667,140,123,34,24,105,97,263,202,58
"629","TA1308000046","Morgan St & 31st St",41.8378,-87.65114,196,195,37,40,147,143,391,290,77
"630","TA1308000047","Southport Ave & Clark St",41.957081,-87.664199,206,182,32,33,168,144,388,312,65
"631","TA1308000049","Wells St & Evergreen Ave",41.906724,-87.63483,1108,1129,263,260,810,817,2237,1627,523
"632","TA1308000050","Wells St & Concord Ln",41.9121026666667,-87.6348533333333,1630,1704,401,401,1163,1245,3334,2408,802
"633","TA1309000001","Halsted St & Maxwell St",41.8648625,-87.6470786666667,312,272,63,54,215,199,584,414,117
"634","TA1309000002","Michigan Ave & Jackson Blvd",41.87785,-87.62408,557,531,71,67,343,364,1088,707,138
"635","TA1309000003","Western Ave & 24th St",41.84847,-87.685109,69,70,22,22,43,47,139,90,44
"636","TA1309000004","LaSalle St & Jackson Blvd",41.878166,-87.631929,622,558,177,155,412,372,1180,784,332
"637","TA1309000006","Larrabee St & Armitage Ave",41.918084,-87.643749,496,467,95,95,384,349,963,733,190
"638","TA1309000007","Franklin St & Monroe St",41.8809288333333,-87.6356518333333,723,621,194,174,487,418,1344,905,368
"639","TA1309000008","Franklin St & Adams St (Temp)",41.8792333333333,-87.6353295,379,402,94,93,258,271,781,529,187
"640","TA1309000010","Wabash Ave & 9th St",41.870769,-87.625734,986,962,271,269,641,586,1948,1227,540
"641","TA1309000011","Ellis Ave & 58th St",41.788746,-87.601334,376,335,44,42,315,285,711,600,86
"642","TA1309000012","Damen Ave & Sunnyside Ave",41.96325,-87.679258,158,132,48,30,108,98,290,206,78
"643","TA1309000014","Clark St & Leland Ave",41.967096,-87.667429,512,493,112,108,382,372,1005,754,220
"644","TA1309000015","Leavitt St & Lawrence Ave",41.968879,-87.6839515,141,142,34,32,99,105,283,204,66
"645","TA1309000018","Ravenswood Ave & Berteau Ave",41.957921,-87.673567,229,236,46,45,181,189,465,370,91
"646","TA1309000019","Lakeview Ave & Fullerton Pkwy",41.925858,-87.638973,1079,1075,227,222,788,787,2154,1575,449
"647","TA1309000021","Paulina St & Montrose Ave",41.9615548333333,-87.671474,170,164,37,37,129,121,334,250,74
"648","TA1309000023","Sheffield Ave & Wrightwood Ave",41.928712,-87.653833,702,698,145,145,536,529,1400,1065,290
"649","TA1309000024","Clark St & Schiller St",41.907993,-87.631501,1005,939,205,195,767,714,1944,1481,400
"650","TA1309000025","Halsted St & Roscoe St",41.94367,-87.64895,905,922,208,205,654,670,1827,1324,413
"651","TA1309000026","Lincoln Ave & Belle Plaine Ave",41.9560035507855,-87.6801614463329,263,290,70,69,183,211,553,394,139
"652","TA1309000027","Sheridan Rd & Buena Ave",41.958494,-87.654966,386,366,60,59,310,289,752,599,119
"653","TA1309000029","Leavitt St & Armitage Ave",41.917805,-87.682437,249,247,49,49,185,187,496,372,98
"654","TA1309000030","Southport Ave & Clybourn Ave",41.920771,-87.663712,396,443,100,100,277,333,839,610,200
"655","TA1309000032","Elston Ave & Wabansia Ave",41.9129853333333,-87.6641846666667,141,150,25,24,110,120,291,230,49
"656","TA1309000033","Sheffield Ave & Webster Ave",41.9217035,-87.6538598333333,706,733,142,139,535,580,1439,1115,281
"657","TA1309000035","Clark St & Winnemac Ave",41.973347640473,-87.6678554713726,577,572,118,113,442,432,1149,874,231
"658","TA1309000036","Burling St & Diversey Pkwy",41.93314,-87.64776,549,608,83,85,454,491,1157,945,168
"659","TA1309000037","Kimbark Ave & 53rd St",41.799568,-87.594747,667,656,96,90,533,528,1323,1061,186
"660","TA1309000039","Lake Shore Dr & Diversey Pkwy",41.932588,-87.636427,959,983,169,172,722,734,1942,1456,341
"661","TA1309000041","Sheridan Rd & Lawrence Ave",41.969517,-87.654691,259,269,74,74,175,187,528,362,148
"662","TA1309000042","Lincoln Ave & Belmont Ave",41.939365,-87.668385,522,531,104,105,393,400,1053,793,209
"663","TA1309000043","Southport Ave & Irving Park Rd",41.954177,-87.664358,285,262,36,35,231,212,547,443,71
"664","TA1309000049","Lake Shore Dr & Belmont Ave",41.940775,-87.639192,962,979,157,153,719,719,1941,1438,310
"665","TA1309000050","Lincoln Ave & Addison St",41.946176,-87.673308,152,152,35,29,115,117,304,232,64
"666","TA1309000051","Commercial Ave & 83rd St",41.744615,-87.551208,7,5,0,0,7,5,12,12,0
"667","TA1309000053","Cottage Grove Ave & 47th St",41.809855,-87.606755,72,64,12,12,52,44,136,96,24
"668","TA1309000055","Emerald Ave & 31st St",41.838198,-87.645143,231,255,33,32,187,212,486,399,65
"669","TA1309000058","Lincoln Ave & Fullerton Ave",41.9259475,-87.649342,1085,1085,237,235,794,802,2170,1596,472
"670","TA1309000059","Racine Ave & Wrightwood Ave",41.928887,-87.658971,328,312,55,54,273,252,640,525,109
"671","TA1309000061","Halsted St & Wrightwood Ave",41.929143,-87.649077,750,734,141,141,583,572,1484,1155,282
"672","TA1309000063","Lake Park Ave & 56th St",41.793242,-87.587782,312,316,31,31,256,253,628,509,62
"673","TA1309000064","Wolcott Ave & Polk St",41.871262,-87.673688,601,574,123,98,471,473,1175,944,221
"674","TA1309000066","Ravenswood Ave & Lawrence Ave",41.9690593333333,-87.6742301666667,525,513,140,141,358,348,1038,706,281
"675","TA1309000067","Cottage Grove Ave & 51st St",41.803038,-87.606615,59,51,5,3,43,37,110,80,8
"676","WL-008","Clinton St & Roosevelt Rd",41.8671177825,-87.6410879593,376,424,97,97,253,300,800,553,194
"677","WL-011","Jefferson St & Monroe St",41.880422,-87.642746,380,349,79,74,285,257,729,542,153
"678","WL-012","Clinton St & Washington Blvd",41.88338,-87.64117,794,726,169,147,586,549,1520,1135,316
