"","station_id","station_name","lat","long","start_n","end_n","e_start_n","e_end_n","c_start_n","c_end_n","total","classic","electric"
"1","","",41.93,-87.72,75290,79187,75290,78729,0,0,154477,0,154019
"2","13001","Michigan Ave & Washington St",41.8838285,-87.6242566666667,1597,1576,564,552,921,920,3173,1841,1116
"3","13006","LaSalle St & Washington St",41.8825481666667,-87.6323655,787,751,429,406,348,333,1538,681,835
"4","13008","Millennium Park",41.8810317,-87.62408432,1565,1668,604,606,729,755,3233,1484,1210
"5","13011","Canal St & Adams St",41.8794641666667,-87.639918,1443,1543,611,647,799,858,2986,1657,1258
"6","13016","St. Clair St & Erie St",41.894079,-87.6225231666667,1988,2127,845,872,1106,1207,4115,2313,1717
"7","13017","Franklin St & Chicago Ave",41.8967469730938,-87.6356676220894,1131,1015,474,456,649,544,2146,1193,930
"8","13021","Clinton St & Lake St",41.885637,-87.641823,1409,1396,664,665,716,714,2805,1430,1329
"9","13022","Streeter Dr & Grand Ave",41.892278,-87.612043,2165,2350,631,641,1123,1218,4515,2341,1272
"10","13028","900 W Harrison St",41.874754,-87.649807,921,900,319,320,578,553,1821,1131,639
"11","13029","Field Museum",41.8652936666667,-87.618081,355,256,99,76,167,136,611,303,175
"12","13033","Milwaukee Ave & Grand Ave",41.891578,-87.648384,1020,1066,587,589,415,458,2086,873,1176
"13","13034","Michigan Ave & Pearson St",41.8963166666667,-87.6243798333333,720,718,225,225,397,435,1438,832,450
"14","13036","Michigan Ave & Madison St",41.882134,-87.625125,729,802,311,328,373,427,1531,800,639
"15","13037","Clinton St & Tilden St",41.875885,-87.640795,225,242,93,107,127,131,467,258,200
"16","13042","Michigan Ave & Oak St",41.9008643333333,-87.6237941666667,1117,1205,392,396,608,679,2322,1287,788
"17","13045","Dearborn St & Erie St",41.893929,-87.6298965,1972,2111,912,929,1021,1119,4083,2140,1841
"18","13050","State St & Kinzie St",41.8891713333333,-87.6276901666667,1095,1218,537,556,545,632,2313,1177,1093
"19","13053","Green St & Randolph St",41.883668,-87.64867,1060,1169,494,515,541,637,2229,1178,1009
"20","13056","Canal St & Monroe St",41.88169,-87.63953,957,850,393,371,542,460,1807,1002,764
"21","13058","Dayton St & North Ave",41.9105780349,-87.6494219288,717,702,311,305,395,389,1419,784,616
"22","13059","Bissell St & Armitage Ave",41.91844,-87.65222,873,972,377,402,475,553,1845,1028,779
"23","13061","Ashland Ave & Division St",41.90345,-87.667747,1551,1574,853,855,670,699,3125,1369,1708
"24","13063","Sheridan Rd & Irving Park Rd",41.954245,-87.654406,883,835,336,332,533,498,1718,1031,668
"25","13068","Western Ave & Winnebago Ave",41.9155536666667,-87.6870211666667,603,602,355,349,220,239,1205,459,704
"26","13071","Southport Ave & Roscoe St",41.9435446666667,-87.664169,1016,1135,415,427,592,698,2151,1290,842
"27","13073","Ashland Ave & Lake St",41.88592,-87.66717,460,335,233,185,220,140,795,360,418
"28","13074","Broadway & Wilson - Truman College Vaccination Site",41.9651225,-87.6583631666667,633,665,301,304,325,356,1298,681,605
"29","13075","Wentworth Ave & Cermak Rd",41.8530845574128,-87.6319313049316,427,457,147,155,251,269,884,520,302
"30","13080","Hermitage Ave & Polk St",41.8715923333333,-87.6698921666667,451,335,150,94,299,240,786,539,244
"31","13081","Ogden Ave & Congress Pkwy",41.87501,-87.67328,257,202,119,83,126,110,459,236,202
"32","13083","Indiana Ave & 40th St",41.82168,-87.6216,27,30,18,19,9,11,57,20,37
"33","13084","California Ave & Milwaukee Ave",41.922695,-87.697153,701,662,455,441,224,202,1363,426,896
"34","13085","Kedzie Ave & Milwaukee Ave",41.929567,-87.707857,729,762,522,509,193,228,1491,421,1031
"35","13089","Damen Ave & Cullerton St",41.8549665187539,-87.6756995916366,149,160,63,73,83,84,309,167,136
"36","13091","Western Ave & 21st St",41.8540356666667,-87.6858568333333,98,80,68,51,28,22,178,50,119
"37","13096","California Ave & 21st St",41.8538040657915,-87.6957423985004,84,78,44,39,39,39,162,78,83
"38","13099","Halsted St & 18th St (Temp)",41.8583706903062,-87.6463884115219,237,250,134,134,98,115,487,213,268
"39","13102","Calumet Ave & 18th St",41.857611,-87.619407,474,479,229,228,227,234,953,461,457
"40","13108","Broadway & Argyle St",41.9737501666667,-87.6597068333333,545,515,210,205,322,302,1060,624,415
"41","13109","Broadway & Berwyn Ave",41.978353,-87.659753,516,530,260,254,244,268,1046,512,514
"42","13124","Cannon Dr & Fullerton Ave",41.9267559875,-87.6344287848,252,228,67,62,159,149,480,308,129
"43","13128","Clark St & North Ave",41.9120506666667,-87.6318421666667,665,601,229,225,414,353,1266,767,454
"44","13132","Damen Ave & Chicago Ave",41.89562,-87.6771395,805,858,420,426,375,421,1663,796,846
"45","13133","Damen Ave & Cortland St",41.915983,-87.677335,630,673,326,321,295,334,1303,629,647
"46","13134","Damen Ave & Madison St",41.881409,-87.6749245,346,293,170,144,146,134,639,280,314
"47","13135","Blue Island Ave & 18th St",41.8574851666667,-87.6616691666667,372,375,181,182,176,171,747,347,363
"48","13136","Damen Ave & Division St",41.903266,-87.678435,596,651,327,333,264,316,1247,580,660
"49","13137","Broadway & Barry Ave",41.937582,-87.644098,1556,1614,599,597,936,998,3170,1934,1196
"50","13138","Canal St & Jackson Blvd",41.8774146666667,-87.639112,754,738,342,340,400,389,1492,789,682
"51","13139","Throop St & Taylor St",41.868968,-87.659141,558,497,169,150,377,341,1055,718,319
"52","13143","Damen Ave & Melrose Ave",41.9405638333333,-87.678549,162,164,71,68,89,94,326,183,139
"53","13144","Seeley Ave & Roscoe St",41.943312,-87.6797028333333,328,345,181,182,142,159,673,301,363
"54","13146","Clark St & Armitage Ave",41.918294,-87.6363436666667,1493,1435,517,506,939,874,2928,1813,1023
"55","13150","Michigan Ave & 18th St",41.857813,-87.62455,593,628,189,199,392,421,1221,813,388
"56","13154","Sheffield Ave & Kingsbury St",41.9105068333333,-87.6530426666667,909,944,423,429,474,499,1853,973,852
"57","13155","Racine Ave & Randolph St",41.8839946666667,-87.6570448333333,383,399,192,187,184,201,782,385,379
"58","13156","Aberdeen St & Monroe St",41.880419,-87.655519,791,740,273,256,469,460,1531,929,529
"59","13157","Aberdeen St & Jackson Blvd",41.8777243333333,-87.6547915,943,870,359,345,573,509,1813,1082,704
"60","13158","Peoria St & Jackson Blvd",41.8775873333333,-87.6494065,1003,1022,418,421,576,591,2025,1167,839
"61","13160","May St & Taylor St",41.8695243333333,-87.6555398333333,752,795,290,290,458,497,1547,955,580
"62","13162","Halsted St & 21st St",41.8537116666667,-87.6464986666667,94,104,48,49,45,51,198,96,97
"63","13163","Morgan St & 18th St",41.858086,-87.651073,338,301,170,159,164,133,639,297,329
"64","13164","Racine Ave & 18th St",41.858166,-87.656495,469,417,215,208,233,192,886,425,423
"65","13165","Racine Ave & 13th St",41.865054,-87.656959,78,71,43,40,31,30,149,61,83
"66","13179","Clark St & Lincoln Ave",41.9156658333333,-87.634619,1269,1226,525,507,718,680,2495,1398,1032
"67","13191","Sedgwick St & Webster Ave",41.922167,-87.638888,1004,932,421,407,573,509,1936,1082,828
"68","13192","Halsted St & Dickens Ave",41.919936,-87.64883,920,967,433,445,479,509,1887,988,878
"69","13193","Larrabee St & Webster Ave",41.921822,-87.64414,1198,1158,470,452,700,671,2356,1371,922
"70","13194","Ogden Ave & Race Ave",41.891795,-87.658751,629,690,315,329,308,356,1319,664,644
"71","13196","Carpenter St & Huron St",41.894556,-87.653449,751,701,453,431,296,268,1452,564,884
"72","13197","Elizabeth (May) St & Fulton St",41.8865733333333,-87.6584548333333,405,466,233,240,167,217,871,384,473
"73","13206","Loomis St & Jackson Blvd",41.877945,-87.662007,494,457,147,136,346,318,951,664,283
"74","13213","State St & 29th St",41.84172,-87.6269946666667,41,66,16,16,25,50,107,75,32
"75","13215","Rhodes Ave & 32nd St",41.836208,-87.613533,298,217,103,88,194,128,515,322,191
"76","13216","State St & 33rd St",41.834734,-87.625813,991,1100,323,334,663,751,2091,1414,657
"77","13217","Calumet Ave & 33rd St",41.8348208333333,-87.6179195,546,451,134,114,410,334,997,744,248
"78","13221","Wood St & Milwaukee Ave",41.9076948333333,-87.6725621666667,872,924,490,500,371,409,1796,780,990
"79","13224","Ashland Ave & Blackhawk St",41.907066,-87.667252,546,561,281,280,262,277,1107,539,561
"80","13229","Southport Ave & Belmont Ave",41.9394777504051,-87.6637476682663,652,616,309,292,329,313,1268,642,601
"81","13235","Southport Ave & Waveland Ave",41.94815,-87.66394,1121,1142,481,480,622,641,2263,1263,961
"82","13241","Western Ave & Division St",41.9029071666667,-87.6872943333333,373,325,250,232,112,88,698,200,482
"83","13242","Milwaukee Ave & Rockwell St",41.920212,-87.6927186666667,249,219,145,124,101,92,468,193,269
"84","13243","Milwaukee Ave & Wabansia Ave",41.912616,-87.681391,745,737,390,389,343,336,1482,679,779
"85","13245","Claremont Ave & Hirsch St",41.907781,-87.685854,183,181,84,80,98,101,364,199,164
"86","13247","Ashland Ave & Chicago Ave",41.8952118333333,-87.6676331666667,511,479,258,242,250,230,990,480,500
"87","13248","Ashland Ave & Augusta Blvd",41.8996256666667,-87.6684148333333,577,510,267,242,309,262,1087,571,509
"88","13249","Ashland Ave & Belle Plaine Ave",41.9560188333333,-87.6688611666667,197,167,70,62,123,105,364,228,132
"89","13253","Lincoln Ave & Waveland Ave",41.948797,-87.675278,266,269,111,122,149,138,535,287,233
"90","13256","California Ave & Division St",41.9030108333333,-87.6974856666667,223,213,132,129,82,70,436,152,261
"91","13257","Campbell Ave & North Ave",41.9105658333333,-87.6895598333333,352,330,250,238,99,91,682,190,488
"92","13258","California Ave & North Ave",41.91044,-87.6972,270,261,164,151,99,99,531,198,315
"93","13259","California Ave & Francis Pl (Temp)",41.9185858333333,-87.6975583333333,192,170,110,98,76,67,362,143,208
"94","13263","Columbus Dr & Randolph St",41.884624,-87.6195396666667,1244,1219,526,525,683,658,2463,1341,1051
"95","13265","Kingsbury St & Erie St",41.8938425,-87.64182,1380,1253,637,593,738,657,2633,1395,1230
"96","13266","Stave St & Armitage Ave",41.917741,-87.691392,295,288,209,201,83,83,583,166,410
"97","13268","Damen Ave & Wellington Ave",41.93588,-87.67842,224,227,128,125,95,98,451,193,253
"98","13269","Ashland Ave & Wellington Ave",41.936083,-87.669807,364,389,189,193,164,190,753,354,382
"99","13271","Damen Ave & Clybourn Ave",41.931931,-87.677856,266,247,161,156,102,89,513,191,317
"100","13276","Stockton Dr & Wrightwood Ave",41.9313063333333,-87.6387761666667,845,789,364,347,452,415,1634,867,711
"101","13277","Broadway & Belmont Ave",41.940106,-87.645451,839,797,268,258,560,522,1636,1082,526
"102","13278","Broadway & Cornelia Ave",41.9455343333333,-87.6463936666667,1095,989,410,383,664,588,2084,1252,793
"103","13285","Wood St & Taylor St (Temp)",41.8693881666667,-87.673608,648,572,238,244,410,322,1220,732,482
"104","13288","Damen Ave & Charleston St",41.9201221666667,-87.678053,365,382,182,186,168,181,747,349,368
"105","13289","Eckhart Park",41.896399,-87.6610183333333,631,640,294,287,328,345,1271,673,581
"106","13290","Noble St & Milwaukee Ave",41.9006746666667,-87.6626166666667,552,575,244,240,301,325,1127,626,484
"107","13292","Kedzie Ave & Palmer Ct",41.9215158333333,-87.7074018333333,278,262,176,170,97,85,540,182,346
"108","13294","Greenview Ave & Diversey Pkwy",41.9325896342979,-87.6659363508224,413,426,190,187,220,235,839,455,377
"109","13296","Ashland Ave & Wrightwood Ave",41.9288411666667,-87.6685348333333,463,456,182,177,279,273,919,552,359
"110","13300","DuSable Lake Shore Dr & Monroe St",41.880958,-87.616743,1651,1480,416,367,873,839,3131,1712,783
"111","13303","Clark St & Chicago Ave",41.89675,-87.63089,959,818,354,333,588,464,1777,1052,687
"112","13304","Racine Ave & 15th St",41.8612801666667,-87.6566395,213,186,118,104,86,76,399,162,222
"113","13307","Laflin St & Cullerton St",41.8548306666667,-87.6636395,169,127,81,68,83,58,296,141,149
"114","13319","Ashland Ave & Grace St",41.950687,-87.6687,468,410,172,165,290,237,878,527,337
"115","13323","Broadway & Sheridan Rd",41.952833,-87.649993,822,788,324,322,479,449,1610,928,646
"116","13325","Broadway & Waveland Ave",41.9491166666667,-87.6485643333333,1225,1215,449,447,760,754,2440,1514,896
"117","13326","Canal St & Harrison St",41.874255,-87.639573,168,149,57,41,110,104,317,214,98
"118","13331","May St & Cullerton St",41.855136,-87.654127,119,118,37,36,79,78,237,157,73
"119","13332","Loomis St & Lexington St",41.8721586666667,-87.661512,1515,1476,511,510,982,955,2991,1937,1021
"120","13338","Mies van der Rohe Way & Chicago Ave",41.89691,-87.621743,1025,1027,400,398,603,600,2052,1203,798
"121","13341","Canal St & Madison St",41.882091,-87.639833,1084,1139,466,488,580,620,2223,1200,954
"122","13345","Calumet Ave & 35th St",41.831379,-87.618034,146,152,45,38,100,113,298,213,83
"123","13353","Ada St & Washington Blvd",41.8828211666667,-87.6613005,664,619,280,266,377,345,1283,722,546
"124","13354","Ashland Ave & 13th St",41.865234,-87.666507,174,244,84,98,89,143,418,232,182
"125","13379","Clarendon Ave & Gordon Ter",41.9578665241517,-87.6495051383972,858,806,385,368,461,429,1664,890,753
"126","13389","Clarendon Ave & Junior Ter",41.9609696666667,-87.6493181666667,580,575,231,234,337,324,1155,661,465
"127","13398","Blackstone Ave & Hyde Park Blvd",41.802562,-87.590368,302,284,59,51,235,228,586,463,110
"128","13409","Sangamon St & Washington Blvd",41.8828571666667,-87.6513301666667,688,708,299,307,379,383,1396,762,606
"129","13420","MLK Jr Dr & Pershing Rd",41.8246,-87.61678,75,72,22,22,41,43,147,84,44
"130","13427","Cityfront Plaza Dr & Pioneer Ct",41.890573,-87.622072,917,795,377,349,503,402,1712,905,726
"131","13430","LaSalle St & Illinois St",41.890974,-87.6315068333333,1397,1457,654,640,687,771,2854,1458,1294
"132","13431","Adler Planetarium",41.866095,-87.607267,367,346,78,64,225,230,713,455,142
"133","13432","Wood St & Hubbard St",41.889899,-87.671473,302,261,159,126,138,134,563,272,285
"134","13434","Ashland Ave & Grand Ave",41.8911298333333,-87.6666635,316,365,182,191,132,168,681,300,373
"135","15442","Ashland Ave & Archer Ave",41.8392353333333,-87.6657046666667,59,51,22,20,36,31,110,67,42
"136","15443","Shields Ave & 28th Pl",41.842733,-87.635491,125,113,33,30,92,83,238,175,63
"137","15445","Wentworth Ave & 33rd St",41.83452988563,-87.6318229814,191,213,55,59,134,154,404,288,114
"138","15446","Racine Ave & 35th St",41.83069611252,-87.6559759116,58,67,25,26,31,37,125,68,51
"139","15449","State St & Pershing Rd",41.82301523798,-87.6265680185,8,7,5,5,3,2,15,5,10
"140","15470","Calumet Ave & 51st St",41.80229465088,-87.6180535802,65,56,32,32,29,20,121,49,64
"141","15491","63rd St Beach",41.780910964248,-87.5763237476349,31,36,6,7,23,28,67,51,13
"142","15529","Mies van der Rohe Way & Chestnut St",41.898845,-87.6226658333333,1136,1073,375,370,721,662,2209,1383,745
"143","15530","Rush St & Superior St",41.89576474564,-87.6259080327,1201,1230,476,471,683,717,2431,1400,947
"144","15534","Field Blvd & South Water St",41.88634906269,-87.6175165471,834,813,424,417,395,383,1647,778,841
"145","15535","Desplaines St & Randolph St",41.88461618962,-87.6445705849,709,660,301,284,395,365,1369,760,585
"146","15539","Desplaines St & Jackson Blvd",41.8781189009123,-87.6439476013184,1037,998,461,448,568,539,2035,1107,909
"147","15541","Buckingham Fountain",41.8765351944122,-87.62047290802,243,240,58,57,134,129,483,263,115
"148","15542","Clinton St & Polk St",41.8713608333333,-87.6408731666667,79,108,35,41,41,66,187,107,76
"149","15544","Shedd Aquarium",41.8672815,-87.6152748333333,972,953,346,329,403,423,1925,826,675
"150","15545","Burnham Harbor",41.856268,-87.613348,412,395,70,69,305,294,807,599,139
"151","15546","Calumet Ave & 21st St",41.85418424947,-87.6191537415,195,188,85,88,102,95,383,197,173
"152","15550","Canal St & Taylor St",41.870257,-87.639474,395,459,190,211,192,237,854,429,401
"153","15571","Broadway & Granville Ave",41.9947668333333,-87.660241,396,403,156,148,229,244,799,473,304
"154","15575","Broadway & Thorndale Ave",41.98974251144,-87.6601406209,346,341,156,152,175,180,687,355,308
"155","15578","Broadway & Ridge Ave",41.9840928333333,-87.6602463333333,450,408,176,165,269,236,858,505,341
"156","15585","Budlong Woods Library",41.983665,-87.696423,146,134,114,108,29,25,280,54,222
"157","15597","Halsted St & 69th St",41.76906172032,-87.6446135779,2,2,0,0,2,2,4,4,0
"158","15599","Calumet Ave & 71st St",41.76550800581,-87.616917925,4,2,2,1,2,1,6,3,3
"159","15615","Christiana Ave & Lawrence Ave",41.9683301666667,-87.7118915,111,106,69,64,39,38,217,77,133
"160","15621","Albany Ave & Montrose Ave",41.9610143333333,-87.7058858333333,106,117,76,74,24,37,223,61,150
"161","15622","California Ave & Montrose Ave",41.961068,-87.695439,160,184,99,99,55,80,344,135,198
"162","15623","Campbell Ave & Montrose Ave",41.9615266666667,-87.6911673333333,208,221,145,147,63,73,429,136,292
"163","15624","Avondale Ave & Irving Park Rd",41.95342,-87.7319545,130,118,103,96,26,19,248,45,199
"164","15628","California Ave & Byron St",41.952162,-87.698051,111,116,77,79,27,32,227,59,156
"165","15631","Troy St & Elston Ave",41.945244,-87.70665,117,136,88,93,25,40,253,65,181
"166","15632","Talman Ave & Addison St",41.9466483333333,-87.6946243333333,150,148,102,102,38,38,298,76,204
"167","15634","Western Ave & Roscoe St",41.9430665,-87.6872903333333,158,161,68,63,88,95,319,183,131
"168","15640","Avers Ave & Belmont Ave",41.939441,-87.7235958333333,134,122,94,93,36,29,256,65,187
"169","15642","California Ave & Fletcher St",41.9384025,-87.6981205,153,165,112,113,33,50,318,83,225
"170","15643","Kosciuszko Park",41.93061,-87.7238508333333,124,154,97,109,23,44,278,67,206
"171","15644","Central Park Ave & Elbridge Ave",41.935337,-87.716889,171,163,127,115,41,47,334,88,242
"172","15645","Richmond St & Diversey Ave",41.9319543333333,-87.7012086666667,134,152,76,77,54,68,286,122,153
"173","15646","California Ave & Altgeld St",41.9266611666667,-87.697829,204,223,153,157,50,63,427,113,310
"174","15648","Campbell Ave & Fullerton Ave",41.92463247165,-87.6893070063,227,230,159,150,61,75,457,136,309
"175","15650","Spaulding Ave & Armitage Ave",41.9171080347893,-87.7102209627628,165,182,97,99,65,82,347,147,196
"176","15651","Humboldt Blvd & Armitage Ave",41.9175121666667,-87.701881,278,260,199,187,76,70,538,146,386
"177","15652","Central Park Ave & North Ave",41.9096208333333,-87.7166108333333,51,47,38,28,10,14,98,24,66
"178","15653","Troy St & North Ave",41.9098351666667,-87.7053275,178,156,116,105,55,46,334,101,221
"179","15654","Spaulding Ave & Division St",41.9027,-87.7092498333333,115,84,74,54,35,27,199,62,128
"180","15655","Albany Ave & Bloomingdale Ave",41.913938,-87.7051393333333,305,304,218,222,79,79,609,158,440
"181","15664","Artesian Ave & Hubbard St",41.8895335,-87.6883401666667,302,222,229,163,66,56,524,122,392
"182","15666","California Ave & Lake St",41.88445395657,-87.6962981368,92,56,58,37,29,18,148,47,95
"183","15667","Western Ave & Monroe St",41.8797245,-87.6860868333333,176,163,126,105,35,47,339,82,231
"184","15668","Western Ave & Congress Pkwy",41.8746606666667,-87.68651,292,249,191,156,93,87,541,180,347
"185","15682","Kedzie Ave & Roosevelt Rd",41.86649278172,-87.7064961757,10,12,3,2,7,10,22,17,5
"186","15685","Central Park Ave & Ogden Ave",41.8538221666667,-87.7150861666667,56,53,32,33,24,20,109,44,65
"187","15686","Kedzie Ave & 21st St",41.85353363213,-87.7050730318,23,23,11,10,12,13,46,25,21
"188","15687","Central Park Ave & 24th St",41.8481468333333,-87.7150515,12,11,6,6,5,4,23,9,12
"189","15689","California Ave & 23rd Pl",41.84910969176,-87.6951398068,52,48,26,28,26,20,100,46,54
"190","15691","Albany Ave & 26th St",41.84447501366,-87.7020130128,10,16,4,4,5,11,26,16,8
"191","15692","California Ave & 26th St",41.8441033333333,-87.695443,26,29,18,19,7,10,55,17,37
"192","16010","Keystone Ave & Fullerton Ave",41.92459,-87.72785,52,59,36,38,16,17,111,33,74
"193","16806","Bosworth Ave & Howard St",42.0195578333333,-87.6695946666667,58,59,31,33,26,24,117,50,64
"194","16903","Cicero Ave & Lake St",41.886841,-87.745261,17,10,10,6,7,3,27,10,16
"195","16905","Central Ave & Lake St",41.8876146666667,-87.7654511666667,21,19,12,11,7,7,40,14,23
"196","16906","Austin Blvd & Lake St",41.8879216666667,-87.7744725,43,39,37,33,6,6,82,12,70
"197","16907","Central Park Blvd & 5th Ave",41.8756846666667,-87.7154606666667,9,5,8,5,1,0,14,0,13
"198","16912","Cicero Ave & Flournoy St",41.872131,-87.746619,9,3,3,1,4,1,12,5,4
"199","16913","Cicero Ave & Quincy St",41.877613,-87.745405,4,3,2,1,2,2,7,4,3
"200","16915","Central Ave & Harrison St",41.872993,-87.764499,16,16,13,12,3,4,32,7,25
"201","16916","Central Ave & Madison St",41.880121,-87.763238,18,15,3,3,15,12,33,27,6
"202","16918","Austin Blvd & Madison St",41.8802653333333,-87.774504,29,26,17,17,9,5,55,14,34
"203","16920","Central Ave & Chicago Ave",41.894958,-87.764902,43,41,29,29,14,11,84,25,58
"204","16921","Austin Blvd & Chicago Ave",41.8948611666667,-87.7745221666667,20,22,11,9,4,8,42,12,20
"205","16932","Ashland Ave & Pershing Rd",41.8234315,-87.665601,24,20,12,12,12,8,44,20,24
"206","16933","Morgan St & Pershing Rd",41.823613,-87.650931,30,35,13,16,7,9,65,16,29
"207","16937","Ashland Ave & McDowell Ave",41.80887,-87.66454,13,9,6,4,7,5,22,12,10
"208","16940","Ashland Ave & 50th St",41.803023,-87.664699,11,4,4,2,4,1,15,5,6
"209","16943","Ashland Ave & Garfield Blvd",41.792822,-87.664429,6,3,1,1,5,1,9,6,2
"210","16948","Ashland Ave & 63rd St",41.779374,-87.664843,10,4,7,4,3,0,14,0,11
"211","16950","Ashland Ave & 66th St",41.7741045,-87.6638008333333,6,4,4,3,2,1,10,3,7
"212","16953","Vincennes Ave & 75th St",41.75797,-87.63121,4,9,2,5,1,4,13,5,7
"213","16970","Bennett Ave & 79th St",41.751785,-87.578496,2,2,1,1,1,1,4,2,2
"214","16991","Milwaukee Ave & Cuyler Ave",41.954468,-87.749594,42,38,29,23,12,13,80,25,52
"215","16994","Kilbourn Ave & Milwaukee Ave",41.9470708941847,-87.7400082349777,20,27,13,13,5,12,47,17,26
"216","17660","California Ave & Cortez St",41.900363,-87.696704,336,345,252,241,81,98,681,179,493
"217","18003","Fairbanks St & Superior St",41.895748,-87.620104,678,654,341,309,331,339,1332,670,650
"218","18016","Bernard St & Elston Ave",41.9499115,-87.7139323333333,89,90,69,71,19,18,179,37,140
"219","18017","Central Park Ave & Bloomingdale Ave",41.914099,-87.7167845,146,151,52,54,92,87,297,179,106
"220","18022","Archer (Damen) Ave & 37th St",41.8267221666667,-87.6831896666667,23,23,6,7,17,16,46,33,13
"221","18025","Carpenter St & 63rd St",41.77987,-87.650919,1,1,0,0,0,0,2,0,0
"222","18058","Leavitt St & Chicago Ave",41.8955176666667,-87.6820386666667,307,286,145,131,152,152,593,304,276
"223","18062","Aberdeen St & Randolph St",41.8841435,-87.6542476666667,665,735,324,328,333,394,1400,727,652
"224","18067","Walsh Park",41.91461,-87.667968,523,442,174,142,339,289,965,628,316
"225","18069","Cherry Ave & Blackhawk St",41.907221,-87.655618,151,176,73,69,77,105,327,182,142
"226","20.0","Damen Ave & Wabansia Ave",41.91,-87.68,130,122,130,122,0,0,252,0,252
"227","20101","Summit Ave & 86th St",41.7378526666667,-87.6449386666667,3,3,3,2,0,0,6,0,5
"228","20102","Loomis St & 89th St",41.7325233333333,-87.6580983333333,11,9,11,9,0,0,20,0,20
"229","20103","Prospect Sq & 91st St",41.728015,-87.6676758333333,10,12,10,10,0,0,22,0,20
"230","20104","State St & 95th St",41.7218499,-87.6228544,56,53,47,45,8,8,109,16,92
"231","20105","Halsted St & 96th St",41.7197113333333,-87.6428383333333,23,13,23,11,0,0,36,0,34
"232","20106","Chicago State University",41.7189673333333,-87.6082803333333,117,110,87,84,25,21,227,46,171
"233","20107","Walden Pkwy & 100th St",41.7122735,-87.6677405,27,19,22,12,2,3,46,5,34
"234","20108","Hale Ave & 107th St",41.6991916666667,-87.6688593333333,11,7,9,7,2,0,18,0,16
"235","20109","Vernon Ave & 107th St",41.7002205,-87.6123275,6,3,4,2,1,0,9,0,6
"236","20110","Eberhart Ave & 91st St",41.729259,-87.6116988333333,7,12,4,7,3,5,19,8,11
"237","20112","Indiana Ave & 103rd St",41.7071702711776,-87.6184719800949,4,4,2,3,2,1,8,3,5
"238","20113","Dauphin Ave & 103rd St",41.7072503677818,-87.6076626777649,6,4,4,2,2,2,10,4,6
"239","20114","Doty Ave & 111th St",41.6950601666667,-87.5987783333333,2,1,2,1,0,0,3,0,3
"240","20116","Dauphin Ave & 87th St",41.736559,-87.601258,8,5,0,0,6,4,13,10,0
"241","20118","Eggleston Ave & 92nd St",41.727628,-87.6348748333333,14,4,14,4,0,0,18,0,18
"242","20119","Elizabeth St & 92nd St",41.726825,-87.6543436666667,6,3,4,3,2,0,9,0,7
"243","20120","Stewart Ave & 83rd St",41.743717,-87.634088,5,3,2,1,3,2,8,5,3
"244","20121","Loomis Blvd & 84th St",41.7414865286181,-87.6584100723267,7,6,3,1,2,3,13,5,4
"245","20123","Western Ave & 104th St",41.7045871021891,-87.6812034845352,27,24,26,19,1,4,51,5,45
"246","20124","Vincennes Ave & 104th St",41.7049833333333,-87.6569906666667,7,7,7,7,0,0,14,0,14
"247","20125","Halsted St & 104th St",41.7051397889324,-87.6424241065979,2,0,0,0,2,0,0,0,0
"248","20126","S Aberdeen St & W 106th St",41.7,-87.65,3,1,3,1,0,0,4,0,4
"249","20127","Halsted St & 111th St",41.6922625558917,-87.6426118612289,9,11,8,9,1,2,20,3,17
"250","20128","S Wentworth Ave & W 111th St",41.69,-87.63,7,6,7,6,0,0,13,0,13
"251","20129","Ada St & 113th St",41.6875586666667,-87.655451,15,14,15,13,0,0,29,0,28
"252","20130","Wentworth Ave & 104th St",41.7053079969982,-87.6292169094086,6,5,5,1,1,4,11,5,6
"253","20131","Cottage Grove Ave & 111th Pl",41.6917403333333,-87.609949,21,10,19,7,1,1,31,2,26
"254","20133","Woodlawn & 103rd - Olive Harvey Vaccination Site",41.71,-87.59,3,5,3,5,0,0,8,0,8
"255","20134","Maryland Ave & 104th St",41.71,-87.6,6,6,6,6,0,0,12,0,12
"256","20201","Kedzie Ave & 104th St",41.7,-87.7,4,2,4,2,0,0,6,0,6
"257","20202","W 103rd St & S Avers Ave",41.71,-87.72,1,1,1,1,0,0,2,0,2
"258","20203","Lawndale Ave & 111th St",41.6912823333333,-87.712849,6,1,6,1,0,0,7,0,7
"259","20204","Kedzie Ave & 110th St",41.6923947458756,-87.7009606361389,9,3,8,2,1,1,12,2,10
"260","20205","Western Ave & 111th St",41.6911528333333,-87.6813181666667,17,8,14,7,2,1,25,3,21
"261","20206","Homewood Ave & 115th St",41.6845956666667,-87.6707448333333,13,3,13,3,0,0,16,0,16
"262","20207","Major Taylor Trail & 115th St",41.6849886666667,-87.6452425,4,5,4,5,0,0,9,0,9
"263","20208","Major Taylor Trail & 124th St",41.6686963533225,-87.6371133327484,3,2,0,0,3,2,5,5,0
"264","20209","S Michigan Ave & E 118th St",41.68,-87.62,6,1,6,1,0,0,7,0,7
"265","20210","State St & 123rd St",41.6706775,-87.622722,11,10,11,10,0,0,21,0,21
"266","20211","Eberhart Ave & 131st St",41.6584131511011,-87.6107108969882,1,0,0,0,1,0,0,0,0
"267","20212","Altgeld Gardens",41.6571103333333,-87.5988201666667,1,1,1,0,0,0,2,0,0
"268","20213","Commercial Ave & 130th St",41.659194,-87.5507215,15,6,14,5,1,1,21,2,19
"269","20214","Avenue O & 134th St",41.6518678022852,-87.5396713614464,8,4,0,0,8,4,12,12,0
"270","20215","Hegewisch Metra Station",41.6485908333333,-87.546205,5,5,4,5,1,0,10,0,9
"271","20217","Torrence Ave & 126th Pl",41.6662625,-87.5571591666667,8,10,5,6,0,0,18,0,11
"272","20218","Avenue O & 118th St",41.681001,-87.537931,6,2,5,0,0,0,8,0,0
"273","20220","Avenue L & 114th St",41.69,-87.54,0,0,0,0,0,0,0,0,0
"274","20221","Torrence Ave & 106th St",41.7028651666667,-87.5598416666667,4,0,4,0,0,0,0,0,0
"275","20222","Burnham Greenway & 105th St",41.7046085,-87.528418,5,7,4,4,1,3,12,4,8
"276","20223","Ewing Ave & Burnham Greenway",41.712748761095,-87.5348138809204,1,1,0,0,1,1,2,2,0
"277","20225","Commercial Ave & 100th St",41.713317395477,-87.5510975718498,5,2,4,0,1,2,7,3,0
"278","20226","Oglesby Ave & 100th St",41.7133161666667,-87.5658868333333,7,6,2,2,4,3,13,7,4
"279","20227","Bradley Park",41.717878301935,-87.5645917654037,4,3,1,1,3,2,7,5,2
"280","20228","Constance Ave & 95th St",41.7220608333333,-87.5789911666667,10,6,8,3,2,2,16,4,11
"281","20229","Baltimore Ave & 87th St",41.7373766666667,-87.5485196666667,6,6,4,4,1,1,12,2,8
"282","20230","Clyde Ave & 87th St",41.7371514643106,-87.572740316391,10,11,1,0,5,5,21,10,0
"283","20231","East End Ave & 87th St",41.7368001666667,-87.5828385,10,8,9,5,1,2,18,3,14
"284","20232","Big Marsh Park",41.685877,-87.573824,18,17,3,2,12,12,35,24,5
"285","20233","Halsted St & 78th St",41.7525538333333,-87.643655,13,5,9,3,4,2,18,6,12
"286","20234","Ashland Ave & 78th St",41.7522848333333,-87.6638291666667,11,5,6,2,5,3,16,8,8
"287","20235","Greenwood Ave & 91st St",41.7287446666667,-87.5972483333333,3,2,2,1,1,1,5,2,3
"288","20236","Stony Island Ave & 90th St",41.7314018333333,-87.5858061666667,25,21,23,17,1,4,46,5,40
"289","20237","Yates Blvd & 93rd St",41.7261728333333,-87.566362,14,13,14,12,0,0,27,0,26
"290","20238","Greenwood Ave & 97th St",41.7187031547574,-87.5970357656479,7,3,4,2,3,1,10,4,6
"291","20239","Marquette Ave & 89th St",41.7336687907147,-87.558342218399,0,0,0,0,0,0,0,0,0
"292","20242","Houston Ave & 92nd St",41.7281943333333,-87.549622,3,2,3,1,0,0,5,0,4
"293","20243","Michigan Ave & 114th St",41.6870147946712,-87.6210522651672,1,0,0,0,1,0,0,0,0
"294","20244","Halsted St & 73rd St",41.761605,-87.644161,4,4,2,1,0,0,8,0,3
"295","20245","Ashland Ave & 74th St",41.7591418333333,-87.6635026666667,8,9,6,7,2,2,17,4,13
"296","20246.0","N Green St & W Lake St",41.89,-87.65,308,292,308,292,0,0,600,0,600
"297","20247.0","W Washington Blvd & N Peoria St",41.88,-87.65,37,38,37,38,0,0,75,0,75
"298","202480.0","Hampden Ct & Diversey Ave",41.93,-87.64,159,154,159,154,0,0,313,0,313
"299","20249.0","N Clark St & W Elm St",41.9,-87.63,2,16,2,16,0,0,18,0,18
"300","20251.0","N Carpenter St & W Lake St",41.89,-87.65,74,57,74,57,0,0,131,0,131
"301","20252.0","W Oakdale Ave & N Broadway",41.94,-87.64,128,129,128,129,0,0,257,0,257
"302","20253.0","N Paulina St & Lincoln Ave",41.94,-87.67,59,52,59,52,0,0,111,0,111
"303","20254.0","W Armitage Ave & N Sheffield Ave",41.92,-87.65,150,140,150,140,0,0,290,0,290
"304","20255.0","N Damen Ave & W Chicago Ave",41.9,-87.68,10,9,10,9,0,0,19,0,19
"305","20256.0","N Sheffield Ave & W Wellington Ave",41.94,-87.65,143,137,143,137,0,0,280,0,280
"306","20257.0","N Southport Ave & W Newport Ave",41.94,-87.66,47,51,47,51,0,0,98,0,98
"307","20260.0","Ping Tom Park (East)",41.86,-87.63,4,3,4,3,0,0,7,0,7
"308","301","Monticello Ave & Chicago Ave",41.9,-87.72,15,14,15,14,0,0,29,0,29
"309","302","Lamon Ave & Chicago Ave",41.9,-87.75,6,2,6,2,0,0,8,0,8
"310","303","Kildare Ave & Division St",41.9,-87.73,11,5,11,5,0,0,16,0,16
"311","304","Lavergne Ave & Division St",41.9,-87.75,7,3,7,3,0,0,10,0,10
"312","305","Menard Ave & Division St",41.9,-87.77,7,6,7,6,0,0,13,0,13
"313","307","Leamington Ave & Hirsch St",41.91,-87.75,12,6,12,6,0,0,18,0,18
"314","308","Major Ave & Bloomingdale Ave",41.91,-87.77,8,2,8,2,0,0,10,0,10
"315","309","Narragansett & McLean",41.92,-87.79,9,9,9,9,0,0,18,0,18
"316","310","North Ave & New England Ave",41.91,-87.8,10,7,10,7,0,0,17,0,17
"317","312","Lockwood Ave & Wrightwood Ave",41.93,-87.76,38,35,38,35,0,0,73,0,73
"318","313","Long Ave & Belden Ave",41.92,-87.76,48,31,48,31,0,0,79,0,79
"319","314","Narragansett & Wrightwood",41.93,-87.79,60,43,60,43,0,0,103,0,103
"320","316","Lamon Ave & Belmont Ave",41.94,-87.75,43,32,43,32,0,0,75,0,75
"321","317","Long Ave & Belmont Ave",41.94,-87.76,39,29,39,29,0,0,68,0,68
"322","318","Oak Park & Wellington",41.93,-87.8,11,8,11,8,0,0,19,0,19
"323","319","Roscoe & Harlem",41.94,-87.81,3,1,3,1,0,0,4,0,4
"324","320","Orange & Addison",41.94,-87.82,9,7,9,7,0,0,16,0,16
"325","321","Kostner Ave & Wrightwood Ave",41.93,-87.74,27,16,27,16,0,0,43,0,43
"326","322","Cicero Ave & Grace St",41.95,-87.75,17,12,17,12,0,0,29,0,29
"327","323","Narragansett & Irving Park",41.95,-87.79,15,11,15,11,0,0,26,0,26
"328","324","Meade Ave & Addison St",41.95,-87.78,28,14,28,14,0,0,42,0,42
"329","325","Harlem Ave & Grace St",41.95,-87.81,12,2,12,2,0,0,14,0,14
"330","326","Harlem & Irving Park",41.95,-87.81,27,21,27,21,0,0,48,0,48
"331","327","Plainfield & Irving Park",41.95,-87.83,3,2,3,2,0,0,5,0,5
"332","329.0","Central Park Ave & Douglas Blvd",41.86,-87.72,14,9,14,9,0,0,23,0,23
"333","330.0","Keeler Ave & Roosevelt Rd",41.87,-87.73,4,4,4,4,0,0,8,0,8
"334","331","Halsted St & Clybourn Ave",41.9096598333333,-87.6481341666667,1122,1197,526,544,579,640,2319,1219,1070
"335","331.0","Pulaski Rd & 21st St",41.85,-87.72,20,24,20,24,0,0,44,0,44
"336","332.0","Harding Ave & 26th St",41.84,-87.72,4,1,4,1,0,0,5,0,5
"337","334.0","Lawndale Ave & 30th St",41.84,-87.72,20,20,20,20,0,0,40,0,40
"338","335.0","Komensky Ave & 31st St",41.84,-87.73,10,10,10,10,0,0,20,0,20
"339","337","Hoyne Ave & 34th St",41.83,-87.68,4,2,4,2,0,0,6,0,6
"340","338","California Ave & 36th St",41.83,-87.69,6,1,6,1,0,0,7,0,7
"341","339","Sacramento Ave & Pershing Rd",41.82,-87.7,9,2,9,2,0,0,11,0,11
"342","341","Archer Ave & 43rd St",41.82,-87.7,5,7,5,7,0,0,12,0,12
"343","343","Pulaski Rd & 51st St",41.8,-87.72,30,21,30,21,0,0,51,0,51
"344","344","Springfield Ave & 47th St",41.81,-87.72,4,4,4,4,0,0,8,0,8
"345","345","Artesian Ave & 55th St",41.79,-87.69,9,6,9,6,0,0,15,0,15
"346","346","Kedzie Ave & 57th St",41.79,-87.7,16,16,16,16,0,0,32,0,32
"347","347","Komensky Ave & 55th St",41.79,-87.72,13,6,13,6,0,0,19,0,19
"348","348","Western Ave & 62nd St",41.78,-87.68,9,3,9,3,0,0,12,0,12
"349","349","Spaulding Ave & 63rd St",41.78,-87.71,10,7,10,7,0,0,17,0,17
"350","350","Hamlin Ave & 62nd Pl",41.78,-87.72,4,2,4,2,0,0,6,0,6
"351","351","Mulligan Ave & Wellington Ave",41.93,-87.78,34,20,34,20,0,0,54,0,54
"352","352","Sayre & Diversey",41.93,-87.8,7,5,7,5,0,0,12,0,12
"353","353","Meade Ave & Diversey Ave",41.93,-87.78,28,23,28,23,0,0,51,0,51
"354","354","Parkside Ave & Armitage Ave",41.92,-87.77,12,1,12,1,0,0,13,0,13
"355","355","Central Ave & Parker Ave",41.93,-87.77,20,12,20,12,0,0,32,0,32
"356","356","Lavergne & Fullerton",41.92,-87.75,38,24,38,24,0,0,62,0,62
"357","357","Lamon Ave & Armitage Ave",41.92,-87.75,36,23,36,23,0,0,59,0,59
"358","358","Kilpatrick Ave & Parker Ave",41.93,-87.74,40,31,40,31,0,0,71,0,71
"359","359","Kilbourn & Belden",41.92,-87.74,30,21,30,21,0,0,51,0,51
"360","360","Kilbourn & Roscoe",41.94,-87.74,41,24,41,24,0,0,65,0,65
"361","361","Kenosha & Wellington",41.93,-87.73,14,4,14,4,0,0,18,0,18
"362","362.0","Lawndale Ave & 16th St",41.86,-87.72,0,0,0,0,0,0,0,0,0
"363","364.0","Homan Ave & Fillmore St",41.87,-87.71,7,1,7,1,0,0,8,0,8
"364","365.0","Kildare Ave & 26th St",41.84,-87.73,1,2,1,2,0,0,3,0,3
"365","366.0","Spaulding Ave & 16th St",41.86,-87.71,3,3,3,3,0,0,6,0,6
"366","368.0","Tripp Ave & 31st St",41.84,-87.73,16,14,16,14,0,0,30,0,30
"367","369","Central Park Ave & Ohio St",41.89,-87.72,2,0,2,0,0,0,0,0,0
"368","370","Central Park & Augusta Blvd",41.9,-87.72,17,13,17,13,0,0,30,0,30
"369","371","Kildare Ave & Chicago Ave",41.9,-87.73,5,4,5,4,0,0,9,0,9
"370","373","Augusta Blvd & Laramie Ave",41.9,-87.76,15,4,15,4,0,0,19,0,19
"371","374","Kilpatrick Ave & Grand Ave",41.91,-87.74,20,6,20,6,0,0,26,0,26
"372","375","Long Ave & North Ave",41.91,-87.76,9,6,9,6,0,0,15,0,15
"373","376","Menard Ave & North Ave",41.91,-87.77,6,3,6,3,0,0,9,0,9
"374","377","Bloomingdale Ave & Harlem Ave",41.91,-87.81,4,1,4,1,0,0,5,0,5
"375","378","Nordica & Medill",41.92,-87.8,17,12,17,12,0,0,29,0,29
"376","379","Rockwell St & Archer Ave",41.82,-87.69,22,14,22,14,0,0,36,0,36
"377","380","Fairfield Ave & 44th St",41.81,-87.69,9,2,9,2,0,0,11,0,11
"378","381","Francisco Ave & 47th St",41.81,-87.7,1,1,1,1,0,0,2,0,2
"379","382","Kedzie Ave & 48th Pl",41.8,-87.7,17,8,17,8,0,0,25,0,25
"380","383","Campbell Ave & 51st St",41.8,-87.69,3,3,3,3,0,0,6,0,6
"381","384","Kedzie Ave & 52nd St",41.8,-87.7,9,4,9,4,0,0,13,0,13
"382","385","St Louis Ave & Norman Bobbins Ave",41.79,-87.71,9,5,9,5,0,0,14,0,14
"383","386","Rockwell St & 57th St",41.79,-87.69,13,7,13,7,0,0,20,0,20
"384","387","St Louis Ave & 59th St",41.79,-87.71,2,5,2,5,0,0,7,0,7
"385","388","Richmond St & 59th St",41.79,-87.7,1,0,1,0,0,0,0,0,0
"386","389","Maplewood Ave & 59th St",41.79,-87.69,7,2,7,2,0,0,9,0,9
"387","390","California Ave & Marquette Rd",41.77,-87.69,12,3,12,3,0,0,15,0,15
"388","393","Oketo Ave & Addison St",41.94,-87.81,11,8,11,8,0,0,19,0,19
"389","394","Panama Ave & Grace St",41.95,-87.83,2,1,2,1,0,0,3,0,3
"390","396","Central Ave & Roscoe St",41.94,-87.77,26,32,26,32,0,0,58,0,58
"391","397","Narragansett Ave & School St",41.94,-87.79,15,14,15,14,0,0,29,0,29
"392","398","Long & Irving Park",41.95,-87.76,55,44,55,44,0,0,99,0,99
"393","399","Lavergne Ave & 46th St",41.81,-87.75,15,14,15,14,0,0,29,0,29
"394","400","Lawler Ave & 50th St",41.8,-87.75,26,17,26,17,0,0,43,0,43
"395","401","Kildare Ave & 47th St",41.81,-87.73,2,0,2,0,0,0,0,0,0
"396","402","Kenneth Ave & 50th St",41.8,-87.73,7,8,7,8,0,0,15,0,15
"397","403","Kildare Ave & 55th St",41.79,-87.73,5,3,5,3,0,0,8,0,8
"398","404","Pulaski Rd & 60th St",41.78,-87.72,16,7,16,7,0,0,23,0,23
"399","406","Kostner Ave & 63rd St",41.78,-87.73,13,16,13,16,0,0,29,0,29
"400","407","Tripp Ave & 65th St",41.77,-87.73,4,3,4,3,0,0,7,0,7
"401","414","Sacramento Blvd & Fulton Ave",41.89,-87.7,1,0,1,0,0,0,0,0,0
"402","415","Western Ave & Lake St",41.88,-87.69,1,0,1,0,0,0,0,0,0
"403","416","Washtenaw Ave & Madison St",41.88,-87.69,1,0,1,0,0,0,0,0,0
"404","418","Mozart St & Jackson Blvd",41.88,-87.7,1,0,1,0,0,0,0,0,0
"405","419","Sacramento Blvd & Polk St",41.87,-87.7,1,2,1,2,0,0,3,0,3
"406","420","Washtenaw Ave & Polk St",41.87,-87.69,1,1,1,1,0,0,2,0,2
"407","424","Sacramento Ave & 25th St",41.85,-87.7,1,3,1,3,0,0,4,0,4
"408","425","Rockwell St & Cermak Rd",41.85,-87.69,23,19,23,19,0,0,42,0,42
"409","427","Whipple St & Roosevelt Rd",41.87,-87.7,2,0,2,0,0,0,0,0,0
"410","428","Milwaukee Ave & Fullerton Ave",41.92,-87.7,121,107,121,107,0,0,228,0,228
"411","429","Francisco Ave & Bloomingdale Ave",41.91,-87.7,19,10,19,10,0,0,29,0,29
"412","430","Troy St & Grace St",41.95,-87.71,38,35,38,35,0,0,73,0,73
"413","431","Western Ave & Grace St",41.95,-87.69,22,22,22,22,0,0,44,0,44
"414","432","Sacramento Blvd & Addison St",41.95,-87.7,8,7,8,7,0,0,15,0,15
"415","433","Elston Ave & Henderson St",41.94,-87.7,11,14,11,14,0,0,25,0,25
"416","434","Albany Ave & Belmont Ave",41.94,-87.71,43,40,43,40,0,0,83,0,83
"417","435","Rockwell St & Fletcher St",41.94,-87.69,40,36,40,36,0,0,76,0,76
"418","436","Kedzie Ave & George St",41.93,-87.71,40,33,40,33,0,0,73,0,73
"419","437","Whipple St & Irving Park Rd",41.95,-87.7,0,0,0,0,0,0,0,0,0
"420","441","Virginia Ave & Catalpa Ave",41.98,-87.7,15,16,15,16,0,0,31,0,31
"421","442","Lincoln Ave & Balmoral Ave",41.98,-87.69,51,55,51,55,0,0,106,0,106
"422","443","California Ave & Winona St",41.97,-87.7,35,29,35,29,0,0,64,0,64
"423","444","N Shore Channel Trail & Argyle Ave",41.97,-87.7,3,2,3,2,0,0,5,0,5
"424","445","Western Ave & Gunnison St",41.97,-87.69,45,35,45,35,0,0,80,0,80
"425","446","Francisco Ave & Montrose Ave",41.96,-87.7,12,14,12,14,0,0,26,0,26
"426","452","Richmond St & Lincoln Ave",41.99,-87.7,12,12,12,12,0,0,24,0,24
"427","458","Washtenaw Ave & Peterson Ave",41.99,-87.7,9,2,9,2,0,0,11,0,11
"428","460","Francisco Ave & Hollywood Ave",41.98,-87.7,3,5,3,5,0,0,8,0,8
"429","462","Lincoln Ave & Peterson Ave",41.99,-87.71,11,6,11,6,0,0,17,0,17
"430","464","Western Ave & Ardmore Ave",41.99,-87.69,2,2,2,2,0,0,4,0,4
"431","466","California Ave & 29th St",41.84,-87.69,0,0,0,0,0,0,0,0,0
"432","471","Damen Ave & 33rd St",41.83,-87.68,10,6,10,6,0,0,16,0,16
"433","472","Elston Ave & George St",41.93,-87.69,38,35,38,35,0,0,73,0,73
"434","473","Mason Ave & Belmont Ave",41.94,-87.77,16,8,16,8,0,0,24,0,24
"435","475","Whipple/Irving Park",41.95,-87.7,18,16,18,16,0,0,34,0,34
"436","514","Ridge Blvd & Howard St",42.0192645,-87.6846,70,53,22,21,47,32,123,79,43
"437","515","Paulina St & Howard St",42.019159,-87.673573,166,162,64,58,99,104,328,203,122
"438","517","Clark St & Jarvis Ave",42.015963,-87.675005,108,80,37,33,67,46,188,113,70
"439","518","Conservatory Dr & Lake St",41.885502,-87.716866,50,56,34,39,16,15,106,31,73
"440","519","Wolcott Ave & Fargo Ave",42.016925,-87.6777285,34,28,22,20,12,8,62,20,42
"441","520","Greenview Ave & Jarvis Ave",42.015962,-87.66857,181,204,74,85,101,114,385,215,159
"442","523","Eastlake Ter & Rogers Ave",42.0208872805206,-87.6650579273701,134,127,71,68,62,56,261,118,139
"443","525","Glenwood Ave & Touhy Ave",42.012701,-87.666058,129,125,25,27,95,90,254,185,52
"444","527","Western Ave & Howard St",42.0189735,-87.6899926666667,60,68,40,48,17,19,128,36,88
"445","528","Pulaski Rd & Lake St",41.8853748333333,-87.726607,34,27,32,27,2,0,61,0,59
"446","530","Laramie Ave & Kinzie St",41.887832,-87.755527,23,10,15,5,8,5,33,13,20
"447","534","Karlov Ave & Madison St",41.880844,-87.7279858333333,12,14,9,8,3,5,26,8,17
"448","535","Pulaski Rd & Congress Pkwy",41.874325,-87.725704,10,8,6,5,4,3,18,7,11
"449","536","Kostner Ave & Lake St",41.885928,-87.73541,15,8,13,5,2,3,23,5,18
"450","537","Kenton Ave & Madison St",41.880708,-87.741018,2,3,0,0,2,3,5,5,0
"451","540","Laramie Ave & Madison St",41.880207,-87.755337,8,7,4,4,3,3,15,6,8
"452","543","Laramie Ave & Gladys Ave",41.875806,-87.755285,5,5,1,1,4,4,10,8,2
"453","545","Kostner Ave & Adams St",41.8779498333333,-87.7360023333333,8,1,8,1,0,0,9,0,9
"454","546","Damen Ave & Pershing Rd",41.823219,-87.6766208333333,20,31,14,14,6,16,51,22,28
"455","549","Marshfield Ave & 44th St",41.813996,-87.666589,33,34,26,25,7,9,67,16,51
"456","553","Elizabeth St & 47th St",41.80839,-87.656526,4,9,1,1,1,7,13,8,2
"457","554","Damen Ave & 51st St",41.8008893333333,-87.6746958333333,7,6,6,3,1,2,13,3,9
"458","557","Seeley Ave & Garfield Blvd",41.794087,-87.675478,2,0,0,0,2,0,0,0,0
"459","559","Racine Ave & Garfield Blvd",41.794228,-87.655073,10,11,7,4,2,7,21,9,11
"460","560","Marshfield Ave & 59th St",41.7867791666667,-87.6661811666667,2,6,2,4,0,0,8,0,6
"461","561","Damen Ave & 59th St",41.7860521666667,-87.6741361666667,6,5,5,4,0,0,11,0,9
"462","562","Racine Ave & 61st St",41.7832033333333,-87.6543575,3,2,2,0,1,2,5,3,0
"463","564","Racine Ave & 65th St",41.7753731666667,-87.6542756666667,5,4,4,3,1,1,9,2,7
"464","567","May St & 69th St",41.7688905,-87.6529615,24,20,22,18,2,2,44,4,40
"465","569","Woodlawn Ave & 75th St",41.75916,-87.595751,3,0,0,0,3,0,0,0,0
"466","570","Evans Ave & 75th St",41.75849,-87.60641,6,3,1,1,5,2,9,7,2
"467","571","Vernon Ave & 75th St",41.758361,-87.614138,3,3,0,0,3,3,6,6,0
"468","572","State St & 76th St",41.7571798333333,-87.6246765,2,3,1,1,1,2,5,3,2
"469","573","State St & 79th St",41.7507775,-87.6244576666667,30,13,20,11,9,2,43,11,31
"470","574","Vernon Ave & 79th St",41.75094,-87.61379,20,11,15,9,5,2,31,7,24
"471","575","Cottage Grove Ave & 78th St",41.7531798333333,-87.6049728333333,10,9,6,7,4,2,19,6,13
"472","576","Greenwood Ave & 79th St",41.751294,-87.597552,4,4,0,0,4,3,8,7,0
"473","577","Stony Island Ave & South Chicago Ave",41.7511435,-87.5853735,9,7,7,3,2,4,16,6,10
"474","579","Phillips Ave & 79th St",41.751845,-87.5652126666667,8,8,5,5,2,1,16,3,10
"475","580","Exchange Ave & 79th St",41.751731,-87.552812,36,27,16,13,20,14,63,34,29
"476","582","Phillips Ave & 83rd St",41.744531,-87.56506,8,2,0,0,8,2,10,10,0
"477","583","Stony Island Ave & 82nd St",41.746559,-87.586005,8,4,7,2,0,0,12,0,9
"478","584","Ellis Ave & 83rd St",41.744123,-87.599034,11,13,2,2,9,11,24,20,4
"479","585","Cottage Grove Ave & 83rd St",41.743441,-87.604836,8,13,6,5,1,7,21,8,11
"480","586","MLK Jr Dr & 83rd St",41.743116,-87.6148,1,2,0,0,1,2,3,3,0
"481","587","Wabash Ave & 83rd St",41.7432865,-87.622754,3,5,3,3,0,0,8,0,6
"482","588","South Chicago Ave & 83rd St",41.743921,-87.575225,8,3,4,1,4,2,11,6,5
"483","590","Kilbourn Ave & Irving Park Rd",41.953733,-87.740569,29,21,16,14,13,7,50,20,30
"484","592","Knox Ave & Montrose Ave",41.960631,-87.745359,41,40,32,27,9,13,81,22,59
"485","593","Halsted St & 59th St",41.787539,-87.644874,2,3,0,0,2,3,5,5,0
"486","594","Western Blvd & 48th Pl",41.805661,-87.683392,15,17,9,7,6,9,32,15,16
"487","595","Wabash Ave & 87th St",41.7366068333333,-87.6226233333333,18,16,14,14,3,2,34,5,28
"488","596","Benson Ave & Church St",42.048214,-87.6835793333333,391,414,174,175,201,217,805,418,349
"489","598","Elmwood Ave & Austin St",42.025784,-87.684107,96,84,60,52,35,32,180,67,112
"490","599","Valli Produce - Evanston Plaza",42.0396416666667,-87.6994263333333,55,55,45,42,10,12,110,22,87
"491","600","Dodge Ave & Church St",42.048308,-87.698224,49,33,18,13,29,18,82,47,31
"492","604","Sheridan Rd & Noyes St (NU)",42.0582,-87.6775528333333,615,648,279,280,307,344,1263,651,559
"493","605","University Library (NU)",42.052939,-87.673447,276,281,120,112,145,159,557,304,232
"494","620","Orleans St & Chestnut St (NEXT Apts)",41.8980185,-87.6375455,690,617,310,278,380,336,1307,716,588
"495","623","Michigan Ave & 8th St",41.872773,-87.623981,829,750,281,255,464,431,1579,895,536
"496","624","Dearborn St & Van Buren St",41.876268,-87.629155,536,494,173,170,340,309,1030,649,343
"497","631","Malcolm X College Vaccination Site",41.877628,-87.6739233333333,132,95,53,43,69,49,227,118,96
"498","632","Clark St & Newport St",41.94454,-87.654678,1095,1085,483,479,590,580,2180,1170,962
"499","636","Orleans St & Hubbard St",41.8897645,-87.6363425,748,668,309,282,433,382,1416,815,591
"500","637","Wood St & Chicago Ave",41.8955955,-87.6722136666667,510,481,224,206,280,268,991,548,430
"501","638","Clinton St & Jackson Blvd",41.8783166118307,-87.6409810781479,1200,1288,567,579,605,685,2488,1290,1146
"502","639","Lakefront Trail & Wilson Ave",41.965845,-87.645361,228,188,39,31,171,151,416,322,70
"503","642","Latrobe Ave & Chicago Ave",41.8946326666667,-87.7568798333333,7,12,2,2,4,9,19,13,4
"504","643","Smith Park",41.8920293333333,-87.6893595,110,113,92,86,16,26,223,42,178
"505","644","Western Ave & Fillmore St",41.8686373333333,-87.6862838333333,503,505,404,407,96,98,1008,194,811
"506","646","State St & 54th St",41.7965806666667,-87.6259266666667,7,1,3,0,4,1,8,5,0
"507","647","Elizabeth St & 59th St",41.7898633333333,-87.6546985,4,2,2,0,2,1,6,3,0
"508","649","Stewart Ave & 63rd St",41.779835,-87.634774,17,14,14,12,3,2,31,5,26
"509","650","Eggleston Ave & 69th St",41.768898,-87.635876,10,7,4,1,6,5,17,11,5
"510","651","Michigan Ave & 71st St",41.765286,-87.621748,6,5,4,3,1,2,11,3,7
"511","652","Rhodes Ave & 71st St",41.766,-87.611726,7,8,4,1,3,7,15,10,5
"512","653","Cornell Dr & Hayes Dr",41.780595,-87.584846,10,11,1,2,9,9,21,18,3
"513","654","Racine Ave & Washington Blvd",41.8830375,-87.6570571666667,361,386,156,160,201,216,747,417,316
"514","655","Hoyne Ave & Balmoral Ave",41.979851,-87.681932,151,165,100,104,44,57,316,101,204
"515","657","Wood St & Augusta Blvd",41.899222,-87.6722021666667,324,335,158,147,164,184,659,348,305
"516","658","Leavitt St & Division St",41.902997,-87.683825,279,255,147,127,128,124,534,252,274
"517","660","Sheridan Rd & Columbia Ave",42.004583,-87.661406,237,277,116,117,117,156,514,273,233
"518","661","Evanston Civic Center",42.056986,-87.6866458333333,133,110,73,71,59,38,243,97,144
"519","662","Dodge Ave & Mulford St",42.0237098333333,-87.6996346666667,30,33,15,18,15,15,63,30,33
"520","665","South Chicago Ave & Elliot Ave",41.7473355,-87.5800278333333,8,7,8,7,0,0,15,0,15
"521","E002","Chicago Ave & Washington St",42.032562,-87.679101,226,236,110,109,115,116,462,231,219
"522","E006","Central St Metra",42.063598,-87.69873,83,86,52,55,30,30,169,60,107
"523","E007","Central St & Girard Ave",42.0642223333333,-87.6861806666667,50,55,23,28,24,27,105,51,51
"524","E008","Chicago Ave & Sheridan Rd",42.0504975,-87.6777856666667,415,403,192,190,207,190,818,397,382
"525","E011","Dodge Ave & Main St",42.0349048333333,-87.6991261666667,30,28,19,18,10,10,58,20,37
"526","E014","Lincolnwood Dr & Central St",42.064854,-87.715297,46,43,20,13,25,29,89,54,33
"527","Hubbard Bike-checking (LBS-WH-TEST)","Base - 2132 W Hubbard Warehouse",41.8899488333333,-87.6802775,14,25,13,17,1,4,39,5,30
"528","KA1503000001","Shields Ave & 43rd St",41.8161823333333,-87.6345953333333,2,2,2,0,0,0,4,0,0
"529","KA1503000002","South Shore Dr & 71st St",41.7664013333333,-87.5657046666667,55,55,24,24,29,29,110,58,48
"530","KA1503000003","Cottage Grove Ave & 71st St",41.76571903697,-87.604959713,8,7,1,2,7,5,15,12,3
"531","KA1503000004","Lake Park Ave & 35th St",41.8313008333333,-87.6088215,95,97,43,38,41,45,192,86,81
"532","KA1503000005","Wentworth Ave & 35th St",41.8307603333333,-87.6324836666667,81,56,37,29,43,25,137,68,66
"533","KA1503000007","Cornell Ave & Hyde Park Blvd",41.802406,-87.586924,525,444,150,136,363,293,969,656,286
"534","KA1503000009","Princeton Ave & 47th St",41.8093405,-87.6334686666667,28,28,12,11,14,15,56,29,23
"535","KA1503000010","Halsted St & 51st St",41.8017716666667,-87.6452513333333,4,4,2,2,2,2,8,4,4
"536","KA1503000011","Halsted St & 56th St",41.79293,-87.64499,2,0,0,0,1,0,0,0,0
"537","KA1503000012","Clark St & Lake St",41.88602082773,-87.6308760584,1187,1105,440,411,728,661,2292,1389,851
"538","KA1503000013","Princeton Ave & Garfield Blvd",41.794982,-87.633124,32,27,15,17,16,9,59,25,32
"539","KA1503000014","Ellis Ave & 60th St",41.78509714636,-87.6010727606,3095,3002,639,607,2442,2383,6097,4825,1246
"540","KA1503000015","Wabash Ave & Adams St",41.87947235235,-87.6256886059,689,670,262,260,409,378,1359,787,522
"541","KA1503000018","Jeffery Blvd & 71st St",41.7665918333333,-87.5763418333333,21,20,12,11,8,9,41,17,23
"542","KA1503000019","Stony Island Ave & 75th St",41.7586696704,-87.586882871,13,12,11,11,2,1,25,3,22
"543","KA1503000020","South Shore Dr & 74th St",41.762189,-87.559275,11,16,5,6,4,8,27,12,11
"544","KA1503000021","Stony Island Ave & 64th St",41.7788438333333,-87.5867128333333,26,21,17,16,8,4,47,12,33
"545","KA1503000022","Clark St & Montrose Ave",41.961588,-87.666036,379,310,164,155,204,148,689,352,319
"546","KA1503000023","Stony Island Ave & 67th St",41.77345849948,-87.5853397391,13,12,2,2,11,10,25,21,4
"547","KA1503000024","Yates Blvd & 75th St",41.7587688333333,-87.5663273333333,5,4,3,2,1,1,9,2,5
"548","KA1503000025","Wentworth Ave & 63rd St",41.7801198333333,-87.6297705,35,20,23,16,11,4,55,15,39
"549","KA1503000027","Prairie Ave & 43rd St",41.8166811666667,-87.6194043333333,40,20,20,12,16,6,60,22,32
"550","KA1503000028","Jeffery Blvd & 76th St",41.7571081666667,-87.5757896666667,6,6,5,3,1,3,12,4,8
"551","KA1503000029","South Shore Dr & 67th St",41.773643,-87.567514,38,38,10,11,26,23,76,49,21
"552","KA1503000030","Jeffery Blvd & 67th St",41.77351755125,-87.5771428255,24,22,7,7,17,15,46,32,14
"553","KA1503000031","Cottage Grove Ave & 67th St",41.773723,-87.6056348333333,14,10,1,2,13,6,24,19,3
"554","KA1503000032","Union Ave & Root St",41.8191091666667,-87.64328,20,34,16,15,3,18,54,21,31
"555","KA1503000033","Eberhart Ave & 61st St",41.7841303333333,-87.6132063333333,25,21,15,16,10,5,46,15,31
"556","KA1503000034","LaSalle St & Adams St",41.8795026666667,-87.632438,396,400,162,145,223,249,796,472,307
"557","KA1503000038","Shields Ave & 31st St",41.838464,-87.635406,282,230,76,61,201,165,512,366,137
"558","KA1503000040","Loomis St & Archer Ave",41.8416833333333,-87.6573583333333,74,89,44,45,24,38,163,62,89
"559","KA1503000041","McClurg Ct & Erie St",41.894503,-87.617854,1463,1476,583,578,855,885,2939,1740,1161
"560","KA1503000043","Kingsbury St & Kinzie St",41.8891306666667,-87.638437,2681,2545,1181,1132,1483,1402,5226,2885,2313
"561","KA1503000044","Rush St & Hubbard St",41.890173,-87.626185,650,572,217,213,409,348,1222,757,430
"562","KA1503000045","Stony Island Ave & 71st St",41.766493,-87.586461,22,21,17,15,4,6,43,10,32
"563","KA1503000046","Dorchester Ave & 63rd St",41.7804056457,-87.5914159893,29,37,9,10,18,21,66,39,19
"564","KA1503000047","Perry Ave & 69th St",41.76929308995,-87.6281959291,5,5,1,1,4,4,10,8,2
"565","KA1503000049","Rainbow Beach",41.75787144829,-87.54938625,10,10,4,2,5,7,20,12,6
"566","KA1503000051","Halsted St & 47th Pl",41.808212,-87.6456523333333,40,45,35,37,5,7,85,12,72
"567","KA1503000052","Ellis Ave & 53rd St",41.79933626261,-87.6009581145,526,482,104,95,413,383,1008,796,199
"568","KA1503000053","MLK Jr Dr & 63rd St",41.780081,-87.615943,26,27,19,19,6,6,53,12,38
"569","KA1503000054","Cottage Grove Ave & 63rd St",41.7806009452142,-87.6058360934258,55,74,29,28,26,45,129,71,57
"570","KA1503000055","Halsted & 63rd - Kennedy-King Vaccination Site",41.77938114228,-87.6446208145,15,6,4,3,11,3,21,14,7
"571","KA1503000059","Lake Park Ave & 53rd St",41.79949429373,-87.5864498959,331,388,92,87,229,291,719,520,179
"572","KA1503000064","Dusable Harbor",41.886976,-87.612813,551,510,123,118,291,294,1061,585,241
"573","KA1503000065","Woodlawn Ave & Lake Park Ave",41.81409271048,-87.5970051479,79,85,26,26,52,57,164,109,52
"574","KA1503000066","Wood St & 35th St",41.830176,-87.670298,43,42,24,23,18,16,85,34,47
"575","KA1503000068","Leavitt St & Archer Ave",41.82879201994,-87.6806044594,51,43,33,33,17,8,94,25,66
"576","KA1503000069","Dorchester Ave & 49th St",41.805772,-87.592464,96,91,47,40,47,50,187,97,87
"577","KA1503000070","Harper Ave & 59th St",41.78794281287,-87.5883151702,537,520,91,83,439,431,1057,870,174
"578","KA1503000071","University Ave & 57th St",41.791478,-87.599861,2833,2966,640,618,2166,2326,5799,4492,1258
"579","KA1503000072","Wacker Dr & Washington St",41.8831488333333,-87.6370921666667,767,677,336,313,418,356,1444,774,649
"580","KA1503000073","MLK Jr Dr & 56th St",41.79342945658,-87.6158532619,18,10,7,5,9,5,28,14,12
"581","KA1503000074","Museum of Science and Industry",41.79172820953,-87.583945009,153,166,54,56,84,84,319,168,110
"582","KA1503000075","DuSable Museum",41.79156801058,-87.6078521774,73,79,19,19,53,57,152,110,38
"583","KA1504000076","Ellis Ave & 55th St",41.79430062054,-87.6014497734,1979,1954,357,340,1608,1600,3933,3208,697
"584","KA1504000078","Lincoln Ave & Winona St",41.9749303333333,-87.6926871666667,149,149,98,98,49,47,298,96,196
"585","KA1504000079","Larrabee St & Division St",41.90348607004,-87.6433534936,748,744,356,344,384,398,1492,782,700
"586","KA1504000080","Washtenaw Ave & Lawrence Ave",41.968987,-87.696027,170,158,108,104,55,49,328,104,212
"587","KA1504000082","Kedzie Ave & Harrison St",41.873654,-87.7048638333333,10,6,4,2,6,2,16,8,6
"588","KA1504000086","Kedzie Ave & 24th St",41.84819094491,-87.7054137458,11,4,8,3,3,0,15,0,11
"589","KA1504000090","St. Louis Ave & Fullerton Ave",41.9249648333333,-87.7144878333333,163,172,112,108,46,61,335,107,220
"590","KA1504000091","Hoyne Ave & 47th St",41.808227,-87.67718,14,18,9,7,5,7,32,12,16
"591","KA1504000093","Rockwell St & Eastwood Ave",41.96590013976,-87.6936384935,204,216,133,130,68,82,420,150,263
"592","KA1504000096","Sawyer Ave & Irving Park Rd",41.9536228333333,-87.7092975,39,51,34,34,5,15,90,20,68
"593","KA1504000097","Drake Ave & Montrose Ave",41.9611481666667,-87.7165316666667,80,71,40,38,38,33,151,71,78
"594","KA150400009X","Kimball Ave & Belmont Ave",41.939398,-87.711561,188,150,113,106,71,36,338,107,219
"595","KA1504000101","Ogden Ave & Roosevelt Rd",41.8664775,-87.6846355,84,68,35,29,48,36,152,84,64
"596","KA1504000102","Fairfield Ave & Roosevelt Rd",41.866624,-87.694521,77,75,63,63,14,12,152,26,126
"597","KA1504000103","Western Ave & Walton St",41.8984218333333,-87.6866545,444,395,226,208,206,177,839,383,434
"598","KA1504000104","Paulina St & Flournoy St",41.87295,-87.66913,714,785,290,281,420,498,1499,918,571
"599","KA1504000106","Kedzie Ave & Lake St",41.8845808333333,-87.706406,47,48,33,33,14,13,95,27,66
"600","KA1504000109","Washtenaw Ave & Ogden Ave",41.8619304927826,-87.6934504508972,48,48,20,20,28,28,96,56,40
"601","KA1504000110","Millard Ave & 26th St",41.8445986666667,-87.7159065,31,21,14,8,17,10,52,27,22
"602","KA1504000113","Sacramento Blvd & Franklin Blvd",41.890507,-87.7025983333333,25,24,9,6,16,16,49,32,15
"603","KA1504000114","Kedzie Ave & Chicago Ave",41.8954681666667,-87.7062005,45,47,25,23,17,23,92,40,48
"604","KA1504000116","Larrabee St & Oak St",41.9001963333333,-87.6430091666667,537,587,253,255,281,330,1124,611,508
"605","KA1504000117","Halsted St & North Branch St",41.89936843921,-87.6484798752,136,138,81,71,55,66,274,121,152
"606","KA1504000126","Kedzie Ave & Leland Ave",41.9666838333333,-87.7080728333333,83,81,66,61,14,16,164,30,127
"607","KA1504000127","Manor Ave & Leland Ave",41.9658406666667,-87.7008483333333,120,103,69,63,51,39,223,90,132
"608","KA1504000128","Kedzie Ave & Foster Ave",41.975672,-87.709261,59,53,19,16,35,37,112,72,35
"609","KA1504000129","Western Ave & Granville Ave",41.99416136902,-87.689438282,74,98,55,65,18,30,172,48,120
"610","KA1504000130","Maplewood Ave & Peterson Ave",41.99023602867,-87.6933696402,34,30,13,11,18,18,64,36,24
"611","KA1504000133","Rush St & Cedar St",41.9023885,-87.6278285,1082,1089,519,521,551,551,2171,1102,1040
"612","KA1504000134","Ritchie Ct & Banks St",41.9066866666667,-87.6261741666667,790,773,368,360,411,394,1563,805,728
"613","KA1504000135","Wells St & Elm St",41.903222,-87.634324,2067,2035,897,891,1143,1116,4102,2259,1788
"614","KA1504000139","Monticello Ave & Irving Park Rd",41.9539883333333,-87.7190593333333,82,90,71,66,9,19,172,28,137
"615","KA1504000140","Winchester Ave & Elston Ave",41.9240958333333,-87.6763818333333,215,231,117,123,98,108,446,206,240
"616","KA1504000141","Pulaski Rd & Eddy St (Temp)",41.946264,-87.731023,28,34,18,21,8,8,62,16,39
"617","KA1504000142","Drake Ave & Addison St",41.9474593333333,-87.7176405,86,71,51,53,32,14,157,46,104
"618","KA1504000143","Leavitt St & Addison St",41.946655,-87.683359,153,184,70,75,80,100,337,180,145
"619","KA1504000146","Clark St & Berwyn Ave",41.978042,-87.6692125,401,471,212,228,173,231,872,404,440
"620","KA1504000147","Winchester (Ravenswood) Ave & Balmoral Ave",41.9797716666667,-87.6775203333333,121,137,56,61,64,76,258,140,117
"621","KA1504000148","Clark St & Elmdale Ave",41.9908604481256,-87.6697236299515,242,220,101,101,135,118,462,253,202
"622","KA1504000149","Damen Ave & Foster Ave",41.9756303333333,-87.679471,256,299,148,161,106,131,555,237,309
"623","KA1504000151","Clark St & Bryn Mawr Ave",41.983593,-87.669154,477,535,224,224,248,300,1012,548,448
"624","KA1504000152","Lakefront Trail & Bryn Mawr Ave",41.98401,-87.6523123333333,476,455,135,118,324,316,931,640,253
"625","KA1504000155","2112 W Peterson Ave",41.9911618333333,-87.6835571666667,65,75,49,53,14,21,140,35,102
"626","KA1504000156","Clark St & Schreiber Ave",41.9992668333333,-87.6714511666667,209,206,89,88,116,111,415,227,177
"627","KA1504000158","Oakley Ave & Irving Park Rd",41.95434085219,-87.6860796243,131,150,47,51,82,96,281,178,98
"628","KA1504000159","Sheridan Rd & Greenleaf Ave",42.010587,-87.662412,123,100,47,44,66,47,223,113,91
"629","KA1504000160","Francisco Ave & Foster Ave",41.97563272521,-87.7014194389,110,113,72,71,34,40,223,74,143
"630","KA1504000161","St. Louis Ave & Balmoral Ave",41.980336,-87.7161348333333,82,70,45,43,36,27,152,63,88
"631","KA1504000162","Clark St & Lunt Ave",42.0090935,-87.6741581666667,234,231,161,160,70,67,465,137,321
"632","KA1504000164","Keystone Ave & Montrose Ave",41.96110801623,-87.7289701012,28,42,25,27,3,14,70,17,52
"633","KA1504000167","Kedzie Ave & Bryn Mawr Ave",41.9822297591152,-87.7088865637779,62,44,28,19,31,23,106,54,47
"634","KA1504000168","Western & 28th - Velasquez Institute Vaccination Site",41.84151770807,-87.6851314409,8,2,5,2,3,0,10,0,7
"635","KA1504000171","Marine Dr & Ainslie St",41.971616,-87.650187,358,299,173,150,169,144,657,313,323
"636","KA1504000175","Glenwood Ave & Morse Ave",42.00797192287,-87.6655023944,263,266,129,132,129,131,529,260,261
"637","KA17018054","Damen Ave & Walnut (Lake) St",41.885965,-87.6769376666667,192,204,114,115,71,78,396,149,229
"638","KA17018068","Leavitt St & Belmont Ave",41.939293,-87.6831863333333,242,243,146,142,93,93,485,186,288
"639","KA1706005007","Delano Ct & Roosevelt Rd",41.8675355,-87.6321671666667,454,425,210,194,228,212,879,440,404
"640","KA1706005015","Kildare Ave & Montrose Ave",41.96108,-87.73569,45,38,15,13,27,23,83,50,28
"641","KP1705001026","LaSalle Dr & Huron St",41.8945833333333,-87.6319503333333,1002,891,396,367,584,503,1893,1087,763
"642","LF-005","DuSable Lake Shore Dr & North Blvd",41.911722,-87.626804,867,852,282,276,501,509,1719,1010,558
"643","LP-","Lincoln Park Conservatory",41.923931,-87.635825,511,573,167,178,315,358,1084,673,345
"644","RN-","Franklin St & Illinois St",41.890985,-87.6353171666667,1126,1052,548,522,566,511,2178,1077,1070
"645","RP-001","Warren Park West",42.001785,-87.688829,56,62,28,26,24,33,118,57,54
"646","RP-002","Warren Park East",42.0045778333333,-87.6806433333333,62,62,40,46,22,15,124,37,86
"647","RP-004","Oakley Ave & Touhy Ave",42.012342,-87.688243,23,33,12,13,9,18,56,27,25
"648","RP-005","Western Ave & Lunt Ave",42.0086095,-87.6904343333333,118,154,63,80,54,73,272,127,143
"649","RP-006","Ridge Blvd & Touhy Ave",42.01213227742,-87.6829126443,39,47,21,22,17,24,86,41,43
"650","RP-007","Clark St & Touhy Ave",42.0125998333333,-87.6742821666667,79,74,58,50,18,18,153,36,108
"651","RP-008","Clark St & Columbia Ave",42.0044566666667,-87.6724021666667,175,163,89,87,82,76,338,158,176
"652","RP-009","Sheridan Rd & Loyola Ave",42.00104377979,-87.6611982433,264,255,132,123,127,123,519,250,255
"653","SL-005","Indiana Ave & Roosevelt Rd",41.867888,-87.623041,1312,1328,496,502,756,745,2640,1501,998
"654","SL-006","Wells St & 19th St",41.856802,-87.633879,137,147,43,42,82,97,284,179,85
"655","SL-007","State St & Harrison St",41.8740375,-87.627743,501,488,206,204,266,257,989,523,410
"656","SL-008","Federal St & Polk St",41.8721365,-87.6295516666667,1284,1194,498,472,759,690,2478,1449,970
"657","SL-009","Clark St & 9th St (AMLI)",41.870816,-87.631246,426,356,171,144,248,211,782,459,315
"658","SL-010","Financial Pl & Ida B Wells Dr",41.8750236280333,-87.6330940425396,598,575,263,249,324,320,1173,644,512
"659","SL-011","Wells St & Polk St",41.872596,-87.633502,905,792,450,406,446,378,1697,824,856
"660","SL-012","Wabash Ave & 16th St",41.860384,-87.625813,575,506,196,183,373,318,1081,691,379
"661","SL-013","State St & 19th St",41.856594,-87.627542,130,143,41,41,88,101,273,189,82
"662","TA1305000001","Wabash Ave & Cermak Rd",41.852619,-87.626488,136,163,63,65,70,92,299,162,128
"663","TA1305000002","Wabash Ave & Roosevelt Rd",41.867199,-87.6260236666667,1250,1252,462,457,750,768,2502,1518,919
"664","TA1305000003","Fairbanks Ct & Grand Ave",41.892195,-87.6206941666667,1437,1358,510,486,884,817,2795,1701,996
"665","TA1305000004","McCormick Place",41.8513751729,-87.6188346489,186,181,68,67,105,90,367,195,135
"666","TA1305000005","Dearborn St & Adams St",41.8784761666667,-87.6290635,723,725,235,225,461,488,1448,949,460
"667","TA1305000006","Dearborn St & Monroe St",41.880793,-87.6294585,1369,1299,521,500,808,768,2668,1576,1021
"668","TA1305000009","Clark St & Ida B Wells Dr",41.8759326655,-87.6305845355,433,555,146,161,275,380,988,655,307
"669","TA1305000010","Michigan Ave & Ida B Wells Dr",41.876243,-87.624426,442,373,173,154,253,209,815,462,327
"670","TA1305000011","Michigan Ave & Lake St",41.886024,-87.624117,1460,1401,497,483,850,820,2861,1670,980
"671","TA1305000014","Clark St & Wrightwood Ave",41.9295496666667,-87.6431518333333,1487,1499,634,637,840,846,2986,1686,1271
"672","TA1305000017","Halsted St & Roosevelt Rd",41.867324,-87.648625,550,460,147,140,386,316,1010,702,287
"673","TA1305000020","Ogden Ave & Chicago Ave",41.896362458,-87.6540612729,695,743,384,385,300,347,1438,647,769
"674","TA1305000022","Orleans St & Merchandise Mart Plaza",41.887893,-87.6371713333333,1444,1272,671,608,764,653,2716,1417,1279
"675","TA1305000025","Franklin St & Jackson Blvd",41.8777079559,-87.6353211408,1294,1194,526,498,702,655,2488,1357,1024
"676","TA1305000029","State St & Randolph St",41.8846210725794,-87.6278342306614,1329,1232,531,490,746,709,2561,1455,1021
"677","TA1305000030","Clark St & Randolph St",41.884576228,-87.63188991,1276,1218,571,533,693,669,2494,1362,1104
"678","TA1305000032","Clinton St & Madison St",41.882242,-87.641066,2103,2145,890,903,1180,1205,4248,2385,1793
"679","TA1305000034","Honore St & Division St",41.903119,-87.673935,583,505,302,257,269,239,1088,508,559
"680","TA1305000035","State St & Van Buren St",41.877181,-87.627844,740,666,281,231,442,408,1406,850,512
"681","TA1305000037","Paulina Ave & North Ave",41.9098546521673,-87.6699301600456,490,472,231,234,256,234,962,490,465
"682","TA1305000039","Elston Ave & Cortland St",41.9164334291265,-87.6667463779449,575,587,313,317,243,256,1162,499,630
"683","TA1305000041","Damen Ave & Pierce Ave",41.9093960065,-87.6776919292,1235,1355,646,672,552,632,2590,1184,1318
"684","TA1306000002","Morgan Ave & 14th Pl",41.862378,-87.651062,286,289,108,111,170,170,575,340,219
"685","TA1306000003","Desplaines St & Kinzie St",41.888504,-87.6444071666667,1738,1594,820,777,900,799,3332,1699,1597
"686","TA1306000006","Orleans St & Elm St",41.90294,-87.6377365,328,285,133,121,194,161,613,355,254
"687","TA1306000007","Larrabee St & Menomonee St",41.91468,-87.64332,408,329,130,116,267,205,737,472,246
"688","TA1306000008","Larrabee St & North Ave",41.91021,-87.6435,405,341,180,165,216,171,746,387,345
"689","TA1306000009","Larrabee St & Kingsbury St",41.897763,-87.643163,1276,1244,624,612,642,630,2520,1272,1236
"690","TA1306000010","Daley Center Plaza",41.884241,-87.629634,1296,1483,535,581,720,861,2779,1581,1116
"691","TA1306000011","Wells St & Walton St",41.899959,-87.6344285,693,562,262,232,422,323,1255,745,494
"692","TA1306000012","Wells St & Huron St",41.894722,-87.634362,2002,1900,938,899,1053,977,3902,2030,1837
"693","TA1306000013","New St & Illinois St",41.8908470406238,-87.6186168193817,1386,1449,686,686,645,728,2835,1373,1372
"694","TA1306000014","Wilton Ave & Diversey Pkwy",41.932418,-87.652705,1157,1154,457,454,687,685,2311,1372,911
"695","TA1306000015","Morgan St & Lake St",41.8854833079,-87.6523048564,1283,1416,613,634,645,748,2699,1393,1247
"696","TA1306000016","Sheffield Ave & Fullerton Ave",41.9254955,-87.6537731666667,1735,1612,688,676,1016,906,3347,1922,1364
"697","TA1306000025","Racine Ave & Congress Pkwy",41.87464,-87.65703,454,412,179,151,269,257,866,526,330
"698","TA1306000026","Racine Ave & Fullerton Ave",41.9256743333333,-87.6584656666667,1147,1148,330,326,802,806,2295,1608,656
"699","TA1306000029","DuSable Lake Shore Dr & Ohio St",41.89257,-87.614492,759,726,295,285,433,404,1485,837,580
"700","TA1306000032","Sheffield Ave & Willow St",41.913688,-87.652855,781,785,302,295,472,482,1566,954,597
"701","TA1307000001","Greenview Ave & Fullerton Ave",41.92533,-87.6658,712,845,335,354,373,478,1557,851,689
"702","TA1307000005","Indiana Ave & 26th St",41.845687,-87.622481,127,141,72,69,53,70,268,123,141
"703","TA1307000006","Southport Ave & Wellington Ave",41.9357126666667,-87.663667,742,742,321,297,415,439,1484,854,618
"704","TA1307000038","Sedgwick St & North Ave",41.9113141666667,-87.6386425,1020,986,382,376,617,603,2006,1220,758
"705","TA1307000039","Clark St & Elm St",41.9026476666667,-87.631739,2423,2391,969,955,1425,1403,4814,2828,1924
"706","TA1307000041","DuSable Lake Shore Dr & Wellington Ave",41.9366813333333,-87.6368598333333,742,779,272,283,447,466,1521,913,555
"707","TA1307000044","Clinton St & 18th St",41.85795,-87.640826,204,221,94,97,110,121,425,231,191
"708","TA1307000048","Fort Dearborn Dr & 31st St",41.838556,-87.608218,213,194,31,27,156,145,407,301,58
"709","TA1307000052","Sheffield Ave & Wellington Ave",41.9361656914064,-87.6516026258469,796,806,277,280,511,511,1602,1022,557
"710","TA1307000061","State St & Pearson St",41.897448,-87.628722,886,787,366,334,500,433,1673,933,700
"711","TA1307000062","Sedgwick St & Huron St",41.8946478333333,-87.6382515,924,937,474,474,441,457,1861,898,948
"712","TA1307000064","Lincoln Ave & Diversey Pkwy",41.932225,-87.658617,1037,988,366,359,659,618,2025,1277,725
"713","TA1307000066","Damen Ave & Coulter St",41.8491808333333,-87.675658,37,46,26,29,8,16,83,24,55
"714","TA1307000070","Damen Ave & Thomas St (Augusta Blvd)",41.9013301666667,-87.6773843333333,558,499,280,255,277,239,1057,516,535
"715","TA1307000107","Sheridan Rd & Montrose Ave",41.961515,-87.654683,857,901,368,376,473,507,1758,980,744
"716","TA1307000111","Franklin St & Lake St",41.885837,-87.6355,1100,1106,565,553,516,531,2206,1047,1118
"717","TA1307000113","Southport Ave & Wrightwood Ave",41.9287986666667,-87.6638048333333,645,703,342,348,299,346,1348,645,690
"718","TA1307000115","Clybourn Ave & Division St",41.904613,-87.640552,406,460,183,195,221,264,866,485,378
"719","TA1307000117","Wabash Ave & Grand Ave",41.891466,-87.626761,1689,1770,682,695,952,995,3459,1947,1377
"720","TA1307000119","Clarendon Ave & Leland Ave",41.9679085,-87.6499378333333,435,437,224,221,201,207,872,408,445
"721","TA1307000120","Green St & Madison St",41.8816788333333,-87.6486891666667,1641,1759,755,786,873,954,3400,1827,1541
"722","TA1307000121","Halsted St & Polk St",41.87184,-87.64664,1023,1019,364,362,651,654,2042,1305,726
"723","TA1307000124","Michigan Ave & 14th St",41.864059,-87.623727,727,754,294,304,415,433,1481,848,598
"724","TA1307000126","Sheffield Ave & Waveland Ave",41.9493291666667,-87.6546118333333,902,911,399,392,486,500,1813,986,791
"725","TA1307000127","Clark St & Grace St",41.950916,-87.6591303333333,857,835,360,349,473,469,1692,942,709
"726","TA1307000128","Dearborn Pkwy & Delaware Pl",41.8989988333333,-87.629898,1282,1376,527,533,721,813,2658,1534,1060
"727","TA1307000129","State St & 35th St",41.831036,-87.626798,313,380,127,142,181,236,693,417,269
"728","TA1307000130","Morgan St & Polk St",41.871737,-87.65103,952,1095,353,367,588,722,2047,1310,720
"729","TA1307000131","Wabash Ave & Wacker Pl",41.8868651666667,-87.6259863333333,769,733,310,296,398,363,1502,761,606
"730","TA1307000134","Wilton Ave & Belmont Ave",41.94018,-87.65304,1533,1477,639,628,870,818,3010,1688,1267
"731","TA1307000136","Clark St & Wellington Ave",41.9364968219,-87.6475386582,1029,1018,389,383,624,611,2047,1235,772
"732","TA1307000138","Lincoln Ave & Roscoe St",41.9437911500595,-87.671257853508,676,679,298,306,363,359,1355,722,604
"733","TA1307000139","MLK Jr Dr & 29th St",41.842062,-87.6168195,634,598,162,157,467,434,1232,901,319
"734","TA1307000140","Western Ave & Leland Ave",41.966399801841,-87.6887042820454,408,453,232,232,165,211,861,376,464
"735","TA1307000142","Clark St & Drummond Pl",41.931248,-87.644336,1256,1290,497,507,742,770,2546,1512,1004
"736","TA1307000143","Sedgwick St & Schiller St",41.907626,-87.638566,328,301,129,120,197,177,629,374,249
"737","TA1307000144","Wolcott (Ravenswood) Ave & Montrose Ave",41.961406,-87.676169,318,292,157,159,155,126,610,281,316
"738","TA1307000149","Ravenswood Ave & Irving Park Rd",41.95469,-87.67393,282,309,120,112,155,191,591,346,232
"739","TA1307000150","Pine Grove Ave & Waveland Ave",41.9494727408833,-87.6464527845383,937,926,343,334,588,578,1863,1166,677
"740","TA1307000151","Wells St & Hubbard St",41.889906,-87.634266,1659,1675,734,729,899,915,3334,1814,1463
"741","TA1307000153","Emerald Ave & 28th St",41.84358,-87.645368,182,189,43,40,137,144,371,281,83
"742","TA1307000156","Lincoln Ave & Sunnyside Ave",41.963004,-87.684781,310,345,156,157,142,175,655,317,313
"743","TA1307000158","Damen Ave & Leland Ave",41.9670718333333,-87.6790853333333,386,318,149,140,228,171,704,399,289
"744","TA1307000159","Paulina St & 18th St",41.857901,-87.668745,279,318,138,144,125,157,597,282,282
"745","TA1307000160","Prairie Ave & Garfield Blvd",41.794853,-87.618691,144,111,39,38,101,71,255,172,77
"746","TA1307000161","Halsted St & 37th St",41.8271055,-87.6456708333333,42,58,29,31,12,25,100,37,60
"747","TA1307000163","Clifton Ave & Armitage Ave",41.918216,-87.656936,651,675,305,305,340,361,1326,701,610
"748","TA1307000164","Woodlawn Ave & 55th St",41.795264,-87.596471,772,661,145,120,616,533,1433,1149,265
"749","TA1307000166","Halsted St & Willow St",41.913865,-87.648755,700,692,339,340,353,347,1392,700,679
"750","TA1308000001","Theater on the Lake",41.926277,-87.630834,797,800,155,146,569,565,1597,1134,301
"751","TA1308000002","Greenwood Ave & 47th St",41.809835,-87.599383,117,108,53,41,62,65,225,127,94
"752","TA1308000005","Leavitt St & North Ave",41.910509366664,-87.6823890209198,395,423,232,235,155,181,818,336,467
"753","TA1308000006","Damen Ave & Grand Ave",41.8912898333333,-87.6768418333333,345,398,203,220,130,171,743,301,423
"754","TA1308000007","MLK Jr Dr & 47th St",41.809851,-87.616279,19,18,2,2,17,16,37,33,4
"755","TA1308000009","Shore Dr & 55th St",41.795212,-87.580715,677,618,191,177,465,410,1295,875,368
"756","TA1308000012","Montrose Harbor",41.963982,-87.638181,311,263,95,81,187,158,574,345,176
"757","TA1308000013","Halsted St & Archer Ave",41.847203,-87.646795,145,109,39,35,100,73,254,173,74
"758","TA1308000014","Normal Ave & Archer Ave",41.849527,-87.640591,74,50,29,21,45,28,124,73,50
"759","TA1308000019","Racine Ave & Belmont Ave",41.939743,-87.658865,808,764,310,304,485,449,1572,934,614
"760","TA1308000021","Winthrop Ave & Lawrence Ave",41.968812,-87.657659,447,400,186,184,251,208,847,459,370
"761","TA1308000022","Pine Grove Ave & Irving Park Rd",41.954383,-87.648043,800,678,282,266,507,404,1478,911,548
"762","TA1308000023","Cottage Grove Ave & 43rd St",41.816499,-87.606582,57,51,13,11,37,36,108,73,24
"763","TA1308000026","Wentworth Ave & 24th St (Temp)",41.8500836934758,-87.6321405172348,98,111,32,33,61,74,209,135,65
"764","TA1308000029","Stetson Ave & South Water St",41.8863813333333,-87.6229753333333,915,795,421,387,464,387,1710,851,808
"765","TA1308000031","Logan Blvd & Elston Ave",41.9294981666667,-87.6841678333333,411,489,265,280,131,205,900,336,545
"766","TA1308000035","Lake Park Ave & 47th St",41.809443,-87.591875,116,121,52,50,61,69,237,130,102
"767","TA1308000036","Indiana Ave & 31st St",41.8387866666667,-87.6218693333333,317,253,98,81,214,171,570,385,179
"768","TA1308000038","Cottage Grove Ave & Oakwood Blvd",41.8229931666667,-87.6071673333333,35,37,13,13,19,16,72,35,26
"769","TA1308000043","Halsted St & 35th St",41.8306603333333,-87.6470921666667,109,122,65,65,35,51,231,86,130
"770","TA1308000045","Wallace St & 35th St",41.834533,-87.6412028333333,164,153,44,37,114,112,317,226,81
"771","TA1308000046","Morgan St & 31st St",41.8378,-87.65114,234,258,137,148,94,106,492,200,285
"772","TA1308000047","Southport Ave & Clark St",41.957081,-87.664199,184,150,72,62,110,88,334,198,134
"773","TA1308000049","Wells St & Evergreen Ave",41.90669,-87.6350043333333,1286,1283,573,572,682,680,2569,1362,1145
"774","TA1308000050","Wells St & Concord Ln",41.912133,-87.634656,2152,2197,992,996,1135,1184,4349,2319,1988
"775","TA1309000001","Halsted St & Maxwell St",41.864883,-87.647071,651,701,285,297,351,383,1352,734,582
"776","TA1309000002","Michigan Ave & Jackson Blvd",41.87785,-87.62408,610,579,203,193,361,319,1189,680,396
"777","TA1309000003","Western Ave & 24th St",41.84847,-87.685109,67,63,44,44,22,18,130,40,88
"778","TA1309000004","LaSalle St & Jackson Blvd",41.878166,-87.631929,1061,1000,505,494,530,492,2061,1022,999
"779","TA1309000006","Larrabee St & Armitage Ave",41.918084,-87.643749,623,622,284,282,331,331,1245,662,566
"780","TA1309000007","Franklin St & Monroe St",41.880317,-87.635185,953,981,559,555,368,387,1934,755,1114
"781","TA1309000008","Franklin St & Adams St (Temp)",41.879434,-87.635504,732,717,336,326,365,343,1449,708,662
"782","TA1309000010","Wabash Ave & 9th St",41.8704401666667,-87.6258343333333,1084,1064,457,462,595,570,2148,1165,919
"783","TA1309000011","Ellis Ave & 58th St",41.788746,-87.601334,994,999,100,95,891,899,1993,1790,195
"784","TA1309000012","Damen Ave & Sunnyside Ave",41.96325,-87.679258,225,201,80,73,141,124,426,265,153
"785","TA1309000014","Clark St & Leland Ave",41.9670685,-87.6674381666667,552,526,254,248,289,270,1078,559,502
"786","TA1309000015","Leavitt St & Lawrence Ave",41.968885,-87.684001,161,146,75,72,83,73,307,156,147
"787","TA1309000018","Ravenswood Ave & Berteau Ave",41.957921,-87.673567,301,306,138,136,159,168,607,327,274
"788","TA1309000019","Lakeview Ave & Fullerton Pkwy",41.925858,-87.638973,1099,1061,419,412,651,625,2160,1276,831
"789","TA1309000021","Paulina St & Montrose Ave",41.9614971666667,-87.671451,217,180,102,94,112,83,397,195,196
"790","TA1309000023","Sheffield Ave & Wrightwood Ave",41.928712,-87.653833,904,834,347,337,540,485,1738,1025,684
"791","TA1309000024","Clark St & Schiller St",41.908045,-87.6315313333333,1273,1219,501,465,760,737,2492,1497,966
"792","TA1309000025","Halsted St & Roscoe St",41.94367,-87.64895,1222,1216,637,634,577,571,2438,1148,1271
"793","TA1309000026","Lincoln Ave & Belle Plaine Ave",41.9560276666667,-87.6802923333333,351,391,181,185,169,200,742,369,366
"794","TA1309000027","Sheridan Rd & Buena Ave",41.958525,-87.6551248333333,581,513,243,230,336,280,1094,616,473
"795","TA1309000029","Leavitt St & Armitage Ave",41.9178166666667,-87.6824298333333,335,319,185,179,148,134,654,282,364
"796","TA1309000030","Southport Ave & Clybourn Ave",41.920771,-87.663712,609,666,331,339,272,316,1275,588,670
"797","TA1309000032","Elston Ave & Wabansia Ave",41.912919,-87.664169,197,202,88,96,107,105,399,212,184
"798","TA1309000033","Sheffield Ave & Webster Ave",41.92154,-87.653818,919,1021,404,421,494,587,1940,1081,825
"799","TA1309000035","Clark St & Winnemac Ave",41.973347640473,-87.6678554713726,858,901,412,413,439,477,1759,916,825
"800","TA1309000036","Burling St & Diversey Pkwy",41.9331488333333,-87.6478496666667,760,846,292,304,457,538,1606,995,596
"801","TA1309000037","Kimbark Ave & 53rd St",41.799568,-87.594747,1087,1109,313,305,762,791,2196,1553,618
"802","TA1309000039","DuSable Lake Shore Dr & Diversey Pkwy",41.932588,-87.636427,699,666,236,221,448,420,1365,868,457
"803","TA1309000041","Sheridan Rd & Lawrence Ave",41.969517,-87.654691,367,376,157,151,209,220,743,429,308
"804","TA1309000042","Lincoln Ave & Belmont Ave",41.939365,-87.668385,806,794,326,326,471,459,1600,930,652
"805","TA1309000043","Southport Ave & Irving Park Rd",41.954177,-87.664358,577,532,173,167,401,362,1109,763,340
"806","TA1309000049","DuSable Lake Shore Dr & Belmont Ave",41.940775,-87.639192,788,851,321,326,443,489,1639,932,647
"807","TA1309000050","Lincoln Ave & Addison St",41.946176,-87.673308,201,249,103,113,94,128,450,222,216
"808","TA1309000051","Commercial Ave & 83rd St",41.744615,-87.551208,7,6,1,0,5,5,13,10,0
"809","TA1309000053","Cottage Grove Ave & 47th St",41.809855,-87.606755,82,83,16,17,66,65,165,131,33
"810","TA1309000055","Emerald Ave & 31st St",41.838198,-87.645143,381,398,170,171,210,224,779,434,341
"811","TA1309000058","Lincoln Ave & Fullerton Ave",41.9241610290676,-87.6463803648949,874,907,397,407,456,487,1781,943,804
"812","TA1309000059","Racine Ave & Wrightwood Ave",41.928887,-87.658971,486,568,181,185,297,380,1054,677,366
"813","TA1309000061","Halsted St & Wrightwood Ave",41.9292193333333,-87.6491568333333,1070,1081,407,409,647,663,2151,1310,816
"814","TA1309000063","Lake Park Ave & 56th St",41.7935541666667,-87.5880231666667,537,505,114,100,415,394,1042,809,214
"815","TA1309000064","Wolcott Ave & Polk St",41.871262,-87.673688,785,818,334,311,449,504,1603,953,645
"816","TA1309000066","Ravenswood Ave & Lawrence Ave",41.96909,-87.674237,990,906,527,501,460,403,1896,863,1028
"817","TA1309000067","Cottage Grove Ave & 51st St",41.8030106666667,-87.6066083333333,53,57,17,17,32,37,110,69,34
"818","Throop/Hastings Mobile Station","Throop/Hastings Mobile Station",41.851560473,-87.659110785,2,1,2,1,0,0,3,0,3
"819","WL-008","Clinton St & Roosevelt Rd",41.8671177825,-87.6410879593,602,649,319,329,260,302,1251,562,648
"820","WL-011","Jefferson St & Monroe St",41.8794469473565,-87.6426815986633,558,491,206,188,344,299,1049,643,394
"821","WL-012","Clinton St & Washington Blvd",41.88338,-87.64117,1916,1999,953,961,941,1025,3915,1966,1914
