,station_id,station_name,lat,long,start_n,end_n,e_start_n,e_end_n,c_start_n,c_end_n,total,classic,electric
1,,,41.89,-87.63,47246,50874,47246,50874,0,0,98120,0,98120
2,13001,Michigan Ave & Washington St,41.88412183,-87.624456,1353,1371,426,422,829,836,2724,1665,848
3,13006,LaSalle St & Washington St,41.88300683,-87.63261833,678,675,382,375,285,290,1353,575,757
4,13008,Millennium Park,41.8810317,-87.62408432,1645,1682,529,523,872,890,3327,1762,1052
5,13011,Canal St & Adams St,41.879528,-87.63977617,1297,1328,513,517,752,786,2625,1538,1030
6,13016,St. Clair St & Erie St,41.89434514,-87.62279838,1268,1293,514,517,706,703,2561,1409,1031
7,13017,Franklin St & Chicago Ave,41.89680017,-87.63562333,957,965,425,423,522,535,1922,1057,848
8,13021,Clinton St & Lake St,41.88547433,-87.64177883,1171,1186,514,504,647,664,2357,1311,1018
9,13022,Streeter Dr & Grand Ave,41.892278,-87.612043,3131,3085,716,673,1852,1852,6216,3704,1389
10,13028,900 W Harrison St,41.87476766,-87.64982927,694,668,253,246,416,396,1362,812,499
11,13029,Field Museum,41.865312,-87.617867,398,297,112,96,225,156,695,381,208
12,13033,Milwaukee Ave & Grand Ave,41.891578,-87.648384,995,913,477,428,499,463,1908,962,905
13,13034,Michigan Ave & Pearson St,41.89766,-87.62351,471,539,165,168,266,324,1010,590,333
14,13036,Michigan Ave & Madison St,41.88194917,-87.62512517,658,608,249,230,362,354,1266,716,479
15,13037,Clinton St & Tilden St,41.875885,-87.640795,266,280,103,107,157,167,546,324,210
16,13042,Michigan Ave & Oak St,41.90099767,-87.62375167,1366,1436,457,471,757,798,2802,1555,928
17,13045,Dearborn St & Erie St,41.893992,-87.629318,1483,1514,569,577,883,904,2997,1787,1146
18,13050,State St & Kinzie St,41.88848767,-87.62749617,1097,1147,460,468,589,626,2244,1215,928
19,13053,Green St & Randolph St,41.88318131,-87.64872462,636,667,249,250,374,401,1303,775,499
20,13056,Canal St & Monroe St,41.88169,-87.63953,870,737,394,333,455,396,1607,851,727
21,13058,Dayton St & North Ave,41.91065167,-87.64938717,606,629,255,256,339,365,1235,704,511
22,13059,Bissell St & Armitage Ave,41.91801814,-87.65218198,819,831,330,326,483,490,1650,973,656
23,13061,Ashland Ave & Division St,41.90345,-87.667747,1312,1359,647,640,637,700,2671,1337,1287
24,13063,Sheridan Rd & Irving Park Rd,41.95430076,-87.65439487,704,689,254,246,432,434,1393,866,500
25,13068,Western Ave & Winnebago Ave,41.91554415,-87.68706989,459,426,187,184,245,220,885,465,371
26,13071,Southport Ave & Roscoe St,41.943739,-87.66402,871,902,307,313,554,579,1773,1133,620
27,13073,Ashland Ave & Lake St,41.88592,-87.66717,317,303,139,132,172,165,620,337,271
28,13074,Broadway & Wilson - Truman College Vaccination Site,41.965221,-87.658139,532,535,205,211,318,314,1067,632,416
29,13075,Wentworth Ave & Cermak Rd,41.85308456,-87.6319313,446,524,150,152,265,315,970,580,302
30,13080,Hermitage Ave & Polk St,41.871514,-87.669886,288,310,91,91,197,219,598,416,182
31,13081,Ogden Ave & Congress Pkwy,41.87500633,-87.67322083,177,183,104,98,73,82,360,155,202
32,13083,Indiana Ave & 40th St,41.8216575,-87.62141967,32,26,13,14,19,12,58,31,27
33,13084,California Ave & Milwaukee Ave,41.922695,-87.697153,621,615,375,365,232,236,1236,468,740
34,13085,Kedzie Ave & Milwaukee Ave,41.929613,-87.70797,609,616,357,351,227,242,1225,469,708
35,13089,Damen Ave & Cullerton St,41.85497217,-87.67555433,143,154,65,72,76,77,297,153,137
36,13091,Western Ave & 21st St,41.854109,-87.685838,76,75,35,32,38,42,151,80,67
37,13096,California Ave & 21st St,41.85378817,-87.695729,82,74,50,40,30,30,156,60,90
38,13099,Halsted St & 18th St,41.85760951,-87.64608896,190,180,79,78,105,98,370,203,157
39,13102,Calumet Ave & 18th St,41.857611,-87.619407,432,450,164,162,250,267,882,517,326
40,13108,Broadway & Argyle St,41.973815,-87.65966,423,411,178,174,223,223,834,446,352
41,13109,Broadway & Berwyn Ave,41.978353,-87.659753,430,477,213,222,208,240,907,448,435
42,13124,Cannon Dr & Fullerton Ave,41.92675599,-87.63442878,271,287,44,40,179,201,558,380,84
43,13128,Clark St & North Ave,41.91201091,-87.63203895,450,461,138,138,301,297,911,598,276
44,13132,Damen Ave & Chicago Ave,41.895567,-87.677128,653,694,363,360,278,326,1347,604,723
45,13133,Damen Ave & Cortland St,41.915983,-87.677335,594,596,244,249,327,329,1190,656,493
46,13134,Damen Ave & Madison St,41.88137,-87.67493,232,195,138,119,89,72,427,161,257
47,13135,Blue Island Ave & 18th St,41.857556,-87.661535,293,284,129,127,152,148,577,300,256
48,13136,Damen Ave & Division St,41.90332583,-87.678514,567,600,273,285,288,307,1167,595,558
49,13137,Broadway & Barry Ave,41.937557,-87.6443145,1285,1342,486,486,762,826,2627,1588,972
50,13138,Canal St & Jackson Blvd,41.87711633,-87.63969467,651,682,294,305,352,365,1333,717,599
51,13139,Throop St & Taylor St,41.86880684,-87.65911424,450,426,157,147,288,274,876,562,304
52,13143,Damen Ave & Melrose Ave,41.9406,-87.6785,126,126,57,55,66,69,252,135,112
53,13144,Seeley Ave & Roscoe St,41.943403,-87.679618,288,301,151,156,132,139,589,271,307
54,13146,Clark St & Armitage Ave,41.918306,-87.636282,1225,1248,447,436,717,748,2473,1465,883
55,13150,Michigan Ave & 18th St,41.85785472,-87.62452114,440,422,118,113,311,295,862,606,231
56,13154,Sheffield Ave & Kingsbury St,41.910629,-87.653104,686,722,272,277,407,436,1408,843,549
57,13155,Racine Ave & Randolph St,41.88401767,-87.65690517,265,285,143,146,110,138,550,248,289
58,13156,Aberdeen St & Monroe St,41.880419,-87.655519,661,653,227,225,400,418,1314,818,452
59,13157,Aberdeen St & Jackson Blvd,41.87772613,-87.65478743,568,537,217,210,348,324,1105,672,427
60,13158,Peoria St & Jackson Blvd,41.87761833,-87.64941117,924,913,367,359,540,536,1837,1076,726
61,13160,May St & Taylor St,41.8694821,-87.6554864,551,519,150,142,399,368,1070,767,292
62,13162,Halsted St & 21st St,41.85377981,-87.64660299,94,82,33,33,56,45,176,101,66
63,13163,Morgan St & 18th St,41.858086,-87.651073,299,298,158,157,132,135,597,267,315
64,13164,Racine Ave & 18th St,41.858227,-87.656445,355,354,145,140,204,203,709,407,285
65,13165,Racine Ave & 13th St,41.865054,-87.656959,61,68,19,21,41,46,129,87,40
66,13179,Clark St & Lincoln Ave,41.915689,-87.6346,1098,1026,372,351,664,619,2124,1283,723
67,13191,Sedgwick St & Webster Ave,41.92210031,-87.63893914,777,755,266,261,504,475,1532,979,527
68,13192,Halsted St & Dickens Ave,41.919936,-87.64883,797,848,361,362,419,465,1645,884,723
69,13193,Larrabee St & Webster Ave,41.921822,-87.64414,907,904,319,310,562,573,1811,1135,629
70,13194,Ogden Ave & Race Ave,41.891795,-87.658751,691,689,302,293,380,390,1380,770,595
71,13196,Carpenter St & Huron St,41.894556,-87.653449,626,500,317,261,303,238,1126,541,578
72,13197,Elizabeth (May) St & Fulton St,41.886616,-87.65804,386,423,228,232,151,180,809,331,460
73,13206,Loomis St & Jackson Blvd,41.87792933,-87.661994,395,363,104,85,284,277,758,561,189
74,13213,State St & 29th St,41.841707,-87.626938,99,85,28,23,70,61,184,131,51
75,13215,Rhodes Ave & 32nd St,41.836738,-87.61335133,198,168,68,65,126,97,366,223,133
76,13216,State St & 33rd St,41.83471933,-87.62576133,550,595,181,183,357,400,1145,757,364
77,13217,Calumet Ave & 33rd St,41.8349,-87.61793,207,179,45,40,155,132,386,287,85
78,13221,Wood St & Milwaukee Ave,41.907655,-87.672552,759,771,347,342,394,414,1530,808,689
79,13224,Ashland Ave & Blackhawk St,41.907066,-87.667252,567,570,225,227,338,337,1137,675,452
80,13229,Southport Ave & Belmont Ave,41.93947775,-87.66374767,449,421,152,149,293,261,870,554,301
81,13235,Southport Ave & Waveland Ave,41.948174,-87.66396733,724,743,254,257,450,474,1467,924,511
82,13241,Western Ave & Division St,41.90288767,-87.68728617,321,299,183,174,132,120,620,252,357
83,13242,Milwaukee Ave & Rockwell St,41.92019556,-87.6926592,242,232,124,117,110,103,474,213,241
84,13243,Milwaukee Ave & Wabansia Ave,41.912616,-87.681391,671,691,327,323,331,355,1362,686,650
85,13245,Claremont Ave & Hirsch St,41.907781,-87.685854,171,141,74,54,93,82,312,175,128
86,13247,Ashland Ave & Chicago Ave,41.8959455,-87.66775617,474,481,226,229,240,245,955,485,455
87,13248,Ashland Ave & Augusta Blvd,41.89966917,-87.66844117,460,414,190,175,269,233,874,502,365
88,13249,Ashland Ave & Belle Plaine Ave,41.956057,-87.668835,164,160,48,53,112,104,324,216,101
89,13253,Lincoln Ave & Waveland Ave,41.948797,-87.675278,227,224,104,95,114,126,451,240,199
90,13256,California Ave & Division St,41.903029,-87.697474,259,258,117,120,127,120,517,247,237
91,13257,Campbell Ave & North Ave,41.910535,-87.689556,323,300,172,166,147,132,623,279,338
92,13258,California Ave & North Ave,41.910434,-87.697183,314,287,179,171,127,106,601,233,350
93,13259,California Ave & Francis Pl (Temp),41.9185415,-87.697496,229,200,123,110,105,87,429,192,233
94,13263,Columbus Dr & Randolph St,41.8845065,-87.6194335,991,856,338,314,599,502,1847,1101,652
95,13265,Kingsbury St & Erie St,41.89416367,-87.64168617,1046,986,396,385,648,596,2032,1244,781
96,13266,Stave St & Armitage Ave,41.917741,-87.691392,228,248,137,137,84,105,476,189,274
97,13268,Damen Ave & Wellington Ave,41.93587683,-87.6785445,236,231,105,105,126,122,467,248,210
98,13269,Ashland Ave & Wellington Ave,41.936083,-87.669807,339,329,117,115,218,210,668,428,232
99,13271,Damen Ave & Clybourn Ave,41.931931,-87.677856,220,209,115,106,103,99,429,202,221
100,13276,Stockton Dr & Wrightwood Ave,41.93132496,-87.63865352,663,695,280,277,363,395,1358,758,557
101,13277,Broadway & Belmont Ave,41.940106,-87.645451,687,752,256,262,406,469,1439,875,518
102,13278,Broadway & Cornelia Ave,41.945529,-87.646439,901,910,366,365,533,525,1811,1058,731
103,13285,Wood St & Taylor St (Temp),41.86926522,-87.67373085,327,360,117,137,205,222,687,427,254
104,13288,Damen Ave & Charleston St,41.92009246,-87.67814219,296,310,159,166,121,137,606,258,325
105,13289,Eckhart Park,41.89637337,-87.66098386,496,479,217,197,266,271,975,537,414
106,13290,Noble St & Milwaukee Ave,41.90073717,-87.66262305,531,473,217,181,308,285,1004,593,398
107,13292,Kedzie Ave & Palmer Ct,41.921525,-87.707322,219,199,121,123,88,67,418,155,244
108,13294,Greenview Ave & Diversey Pkwy,41.93258963,-87.66593635,310,281,127,122,178,155,591,333,249
109,13296,Ashland Ave & Wrightwood Ave,41.928824,-87.6686005,306,298,109,106,195,189,604,384,215
110,13300,DuSable Lake Shore Dr & Monroe St,41.880958,-87.616743,1869,1836,462,437,1043,1085,3705,2128,899
111,13303,Clark St & Chicago Ave,41.89676833,-87.6308695,587,559,242,237,329,306,1146,635,479
112,13304,Racine Ave & 15th St,41.861267,-87.656625,147,128,71,61,74,60,275,134,132
113,13307,Laflin St & Cullerton St,41.8547885,-87.6637005,156,159,71,71,80,86,315,166,142
114,13319,Ashland Ave & Grace St,41.950687,-87.6687,342,358,130,129,203,211,700,414,259
115,13323,Broadway & Sheridan Rd,41.952833,-87.649993,633,598,244,223,377,369,1231,746,467
116,13325,Broadway & Waveland Ave,41.94909217,-87.64857517,1027,959,396,374,618,574,1986,1192,770
117,13326,Canal St & Harrison St,41.874255,-87.639573,174,156,60,59,110,92,330,202,119
118,13331,May St & Cullerton St,41.855136,-87.654127,135,137,55,54,78,81,272,159,109
119,13332,Loomis St & Lexington St,41.872187,-87.661501,1031,984,270,263,749,701,2015,1450,533
120,13338,Mies van der Rohe Way & Chicago Ave,41.89724517,-87.6211655,844,873,329,325,489,521,1717,1010,654
121,13341,Canal St & Madison St,41.882091,-87.639833,1029,1078,426,434,581,622,2107,1203,860
122,13345,Calumet Ave & 35th St,41.831379,-87.618034,101,93,24,21,77,72,194,149,45
123,13353,Ada St & Washington Blvd,41.88283,-87.661206,433,453,192,194,236,249,886,485,386
124,13354,Ashland Ave & 13th St,41.865234,-87.666507,152,162,51,48,101,110,314,211,99
125,13379,Clarendon Ave & Gordon Ter,41.95786652,-87.64950514,641,587,243,229,384,341,1228,725,472
126,13389,Clarendon Ave & Junior Ter,41.961004,-87.649603,437,437,200,205,234,217,874,451,405
127,13398,Blackstone Ave & Hyde Park Blvd,41.802562,-87.590368,197,188,53,47,139,136,385,275,100
128,13409,Sangamon St & Washington Blvd,41.883165,-87.6511,542,577,210,207,318,361,1119,679,417
129,13420,MLK Jr Dr & Pershing Rd,41.8246,-87.61678,77,64,36,26,40,36,141,76,62
130,13427,Cityfront Plaza Dr & Pioneer Ct,41.890573,-87.622072,772,676,294,260,431,373,1448,804,554
131,13430,LaSalle St & Illinois St,41.89096783,-87.63185,1145,1175,442,436,661,692,2320,1353,878
132,13431,Adler Planetarium,41.866095,-87.607267,672,649,187,173,360,391,1321,751,360
133,13432,Wood St & Hubbard St,41.889899,-87.671473,251,248,105,104,143,141,499,284,209
134,13434,Ashland Ave & Grand Ave,41.891091,-87.666743,387,382,164,168,217,208,769,425,332
135,15442,Ashland Ave & Archer Ave,41.83907414,-87.66551471,59,53,30,27,25,22,112,47,57
136,15443,Shields Ave & 28th Pl,41.842733,-87.635491,104,108,26,24,77,81,212,158,50
137,15445,Wentworth Ave & 33rd St,41.83452989,-87.63182298,156,142,29,20,122,120,298,242,49
138,15446,Racine Ave & 35th St,41.83068856,-87.65621066,85,79,40,35,44,42,164,86,75
139,15449,State St & Pershing Rd,41.82304117,-87.6265965,21,22,16,14,5,8,43,13,30
140,15470,Calumet Ave & 51st St,41.80228883,-87.6180995,50,46,23,22,24,24,96,48,45
141,15491,63rd St Beach,41.78091096,-87.57632375,48,51,9,8,27,31,99,58,17
142,15529,Mies van der Rohe Way & Chestnut St,41.898902,-87.622706,791,813,257,263,476,513,1604,989,520
143,15530,Rush St & Superior St,41.89533617,-87.62518017,888,935,354,353,510,554,1823,1064,707
144,15534,Field Blvd & South Water St,41.88620683,-87.61764217,588,597,278,277,280,281,1185,561,555
145,15535,Desplaines St & Randolph St,41.88461619,-87.64457058,598,601,225,227,355,366,1199,721,452
146,15539,Desplaines St & Jackson Blvd,41.87814067,-87.64424117,775,730,339,329,431,400,1505,831,668
147,15541,Buckingham Fountain,41.87653519,-87.62047291,336,291,114,85,165,151,627,316,199
148,15542,Clinton St & Polk St,41.87146652,-87.64094913,50,46,21,21,26,25,96,51,42
149,15544,Shedd Aquarium,41.86722596,-87.61535539,1130,1066,288,269,567,570,2196,1137,557
150,15545,Burnham Harbor,41.8562845,-87.61325633,487,489,65,61,371,385,976,756,126
151,15546,Calumet Ave & 21st St,41.85418425,-87.61915374,193,205,84,84,96,109,398,205,168
152,15550,Canal St & Taylor St,41.8701325,-87.63948133,345,356,155,156,166,191,701,357,311
153,15571,Broadway & Granville Ave,41.99470282,-87.66038907,318,318,90,87,208,218,636,426,177
154,15575,Broadway & Thorndale Ave,41.98974251,-87.66014062,295,311,119,115,162,182,606,344,234
155,15576,Lakefront Trail & Bryn Mawr Ave,41.98404412,-87.65228122,568,562,157,157,380,371,1130,751,314
156,15578,Broadway & Ridge Ave,41.98404461,-87.66027383,337,314,138,132,193,176,651,369,270
157,15585,Budlong Woods Library,41.98366471,-87.69642256,56,56,22,21,34,35,112,69,43
158,15597,Halsted St & 69th St,41.76902667,-87.644644,8,2,5,0,3,2,10,5,0
159,15599,Calumet Ave & 71st St,41.76550801,-87.61691793,2,2,0,0,2,1,4,3,0
160,15615,Christiana Ave & Lawrence Ave,41.96835449,-87.71183067,95,97,51,53,41,38,192,79,104
161,15621,Albany Ave & Montrose Ave,41.961041,-87.705866,83,100,42,43,39,48,183,87,85
162,15622,California Ave & Montrose Ave,41.961068,-87.695439,166,159,82,83,74,67,325,141,165
163,15623,Campbell Ave & Montrose Ave,41.96152593,-87.69116504,220,209,121,116,98,92,429,190,237
164,15624,Avondale Ave & Irving Park Rd,41.95349783,-87.73196183,89,79,62,54,22,25,168,47,116
165,15628,California Ave & Byron St,41.95216219,-87.69805111,131,125,77,69,48,51,256,99,146
166,15631,Troy St & Elston Ave,41.94523233,-87.7065775,102,120,57,56,41,63,222,104,113
167,15632,Talman Ave & Addison St,41.94663583,-87.69461476,227,202,134,126,90,74,429,164,260
168,15634,Western Ave & Roscoe St,41.943034,-87.687288,139,130,51,47,85,80,269,165,98
169,15640,Avers Ave & Belmont Ave,41.93942511,-87.72355735,111,120,80,89,27,24,231,51,169
170,15642,California Ave & Fletcher St,41.93842879,-87.69800776,136,164,70,72,63,82,300,145,142
171,15643,Kosciuszko Park,41.93058537,-87.72377736,105,114,56,57,46,55,219,101,113
172,15644,Central Park Ave & Elbridge Ave,41.93539143,-87.71684718,129,126,91,91,35,33,255,68,182
173,15645,Richmond St & Diversey Ave,41.9320055,-87.70121467,103,111,56,59,46,49,214,95,115
174,15646,California Ave & Altgeld St,41.926703,-87.6977175,175,165,96,94,75,65,340,140,190
175,15648,Campbell Ave & Fullerton Ave,41.92464717,-87.68931833,155,140,76,76,78,62,295,140,152
176,15650,Spaulding Ave & Armitage Ave,41.91710803,-87.71022096,256,250,148,145,97,95,506,192,293
177,15651,Humboldt Blvd & Armitage Ave,41.91751339,-87.70180896,249,248,144,138,100,104,497,204,282
178,15652,Central Park Ave & North Ave,41.90965688,-87.71663195,74,85,53,54,16,27,159,43,107
179,15653,Troy St & North Ave,41.9097693,-87.70528049,129,133,57,58,70,60,262,130,115
180,15654,Spaulding Ave & Division St,41.90273178,-87.70922852,158,155,107,102,41,47,313,88,209
181,15655,Albany Ave & Bloomingdale Ave,41.914027,-87.705126,257,239,136,130,106,99,496,205,266
182,15664,Artesian Ave & Hubbard St,41.88953267,-87.6880955,280,242,200,173,77,67,522,144,373
183,15666,California Ave & Lake St,41.884454,-87.696298,76,67,50,47,24,19,143,43,97
184,15667,Western Ave & Monroe St,41.87978771,-87.68611281,122,116,52,50,62,64,238,126,102
185,15668,Western Ave & Congress Pkwy,41.87474885,-87.68644528,232,216,132,105,98,111,448,209,237
186,15682,Kedzie Ave & Roosevelt Rd,41.86649278,-87.70649618,12,9,7,8,5,1,21,6,15
187,15685,Central Park Ave & Ogden Ave,41.854064,-87.715117,48,44,9,9,34,33,92,67,18
188,15686,Kedzie Ave & 21st St,41.85353363,-87.70507303,8,11,3,4,5,7,19,12,7
189,15687,Central Park Ave & 24th St,41.8481955,-87.71506167,8,15,5,8,3,5,23,8,13
190,15689,California Ave & 23rd Pl,41.84910969,-87.69513981,50,44,19,19,30,25,94,55,38
191,15691,Albany Ave & 26th St,41.84458033,-87.70212017,15,16,9,6,6,10,31,16,15
192,15692,California Ave & 26th St,41.84367991,-87.69496858,29,30,24,22,4,8,59,12,46
193,16010,Keystone Ave & Fullerton Ave,41.92462717,-87.7278715,46,54,22,25,22,27,100,49,47
194,16806,Bosworth Ave & Howard St,42.019537,-87.669563,59,58,10,9,45,47,117,92,19
195,16903,Cicero Ave & Lake St,41.886841,-87.745261,26,16,19,12,5,4,42,9,31
196,16905,Central Ave & Lake St,41.887664,-87.765469,7,6,3,3,2,2,13,4,6
197,16906,Austin Blvd & Lake St,41.88805961,-87.77426541,19,25,11,12,4,9,44,13,23
198,16907,Central Park Blvd & 5th Ave,41.875679,-87.71547,12,13,1,0,8,9,25,17,0
199,16912,Cicero Ave & Flournoy St,41.872131,-87.746619,1,4,0,0,1,4,5,5,0
200,16913,Cicero Ave & Quincy St,41.877613,-87.745405,2,1,0,0,2,0,3,0,0
201,16915,Central Ave & Harrison St,41.872993,-87.764499,10,5,6,4,3,1,15,4,10
202,16916,Central Ave & Madison St,41.880121,-87.763238,10,11,2,2,8,9,21,17,4
203,16918,Austin Blvd & Madison St,41.880281,-87.774453,21,14,12,7,6,3,35,9,19
204,16920,Central Ave & Chicago Ave,41.89495133,-87.76489383,38,30,19,14,18,16,68,34,33
205,16921,Austin Blvd & Chicago Ave,41.894887,-87.774704,14,16,6,5,8,10,30,18,11
206,16932,Ashland Ave & Pershing Rd,41.8234325,-87.66560267,12,10,7,5,5,5,22,10,12
207,16933,Morgan St & Pershing Rd,41.823613,-87.650931,6,11,2,0,2,11,17,13,0
208,16937,Ashland Ave & McDowell Ave,41.80889809,-87.66451371,16,12,13,6,3,6,28,9,19
209,16940,Ashland Ave & 50th St,41.80298233,-87.66468871,7,11,5,4,2,7,18,9,9
210,16943,Ashland Ave & Garfield Blvd,41.792822,-87.664429,7,6,4,5,2,1,13,3,9
211,16948,Ashland Ave & 63rd St,41.779374,-87.664843,16,9,6,3,10,6,25,16,9
212,16950,Ashland Ave & 66th St,41.77405917,-87.66375967,2,4,2,3,0,0,6,0,5
213,16953,Vincennes Ave & 75th St,41.75797,-87.63121,5,3,0,0,4,3,8,7,0
214,16970,Bennett Ave & 79th St,41.75179067,-87.57856267,9,3,1,0,8,3,12,11,0
215,16991,Milwaukee Ave & Cuyler Ave,41.95449817,-87.74958944,48,58,32,33,13,22,106,35,65
216,16994,Kilbourn Ave & Milwaukee Ave,41.94707089,-87.74000823,13,13,6,6,7,7,26,14,12
217,17660,California Ave & Cortez St,41.90035983,-87.6966615,368,317,237,206,123,103,685,226,443
218,18003,Fairbanks St & Superior St,41.895748,-87.620104,540,577,208,218,324,344,1117,668,426
219,18016,Bernard St & Elston Ave,41.94997217,-87.71394133,83,82,55,58,28,23,165,51,113
220,18017,Central Park Ave & Bloomingdale Ave,41.914166,-87.716755,167,181,51,57,104,108,348,212,108
221,18022,Archer (Damen) Ave & 37th St,41.826712,-87.683144,37,35,16,13,17,18,72,35,29
222,18025,Carpenter St & 63rd St,41.77987,-87.650919,1,1,0,0,1,1,2,2,0
223,18058,Leavitt St & Chicago Ave,41.895501,-87.682017,272,279,139,135,131,130,551,261,274
224,18062,Aberdeen St & Randolph St,41.884114,-87.654264,617,683,270,279,329,396,1300,725,549
225,18067,Walsh Park,41.91461,-87.667968,520,434,130,114,378,309,954,687,244
226,18069,Cherry Ave & Blackhawk St,41.90720904,-87.65559506,120,127,63,63,54,64,247,118,126
227,20,Damen Ave & Wabansia Ave,41.91,-87.68,137,120,137,120,0,0,257,0,257
228,20101,Summit Ave & 86th St,41.73785217,-87.644965,9,6,7,4,2,2,15,4,11
229,20102,Loomis St & 89th St,41.73237975,-87.65806943,23,18,17,13,6,5,41,11,30
230,20103,Prospect Sq & 91st St,41.72793217,-87.66763267,24,19,20,14,3,4,43,7,34
231,20104,State St & 95th St,41.7218499,-87.6228544,25,16,15,8,9,8,41,17,23
232,20105,Halsted St & 96th St,41.71971218,-87.64301956,11,6,6,4,5,2,17,7,10
233,20106,Chicago State University,41.71896342,-87.60829568,28,26,19,16,6,7,54,13,35
234,20107,Walden Pkwy & 100th St,41.712178,-87.667683,26,10,23,8,2,2,36,4,31
235,20108,Hale Ave & 107th St,41.699206,-87.668919,25,26,11,10,5,7,51,12,21
236,20109,Vernon Ave & 107th St,41.70018333,-87.61236467,9,6,5,4,4,2,15,6,9
237,20110,Eberhart Ave & 91st St,41.90218467,-87.75093183,9,7,6,2,3,5,16,8,8
238,20111,Olive Harvey College,41.70958114,-87.59023368,13,4,10,3,3,1,17,4,13
239,20112,Indiana Ave & 103rd St,41.70717027,-87.61847198,3,2,1,0,2,2,5,4,0
240,20113,Dauphin Ave & 103rd St,41.70725037,-87.60766268,6,8,1,2,3,5,14,8,3
241,20114,Doty Ave & 111th St,41.69501045,-87.59871483,7,2,2,0,5,2,9,7,0
242,20116,Dauphin Ave & 87th St,41.73655902,-87.60125756,16,4,10,2,6,2,20,8,12
243,20118,Eggleston Ave & 92nd St,41.7276535,-87.63485067,9,4,9,4,0,0,13,0,13
244,20119,Elizabeth St & 92nd St,41.72687113,-87.65428746,6,3,5,3,1,0,9,0,8
245,20120,Stewart Ave & 83rd St,41.743717,-87.634088,7,7,2,2,5,5,14,10,4
246,20121,Loomis Blvd & 84th St,41.74153217,-87.65844033,22,17,18,11,4,6,39,10,29
247,20123,Western Ave & 104th St,41.7045871,-87.68120348,18,15,5,4,13,10,33,23,9
248,20124,Vincennes Ave & 104th St,41.70498567,-87.65708,20,13,19,12,1,1,33,2,31
249,20125,Halsted St & 104th St,41.70519633,-87.64247083,11,8,10,7,1,1,19,2,17
250,20126,S Aberdeen St & W 106th St,41.7,-87.65,7,3,7,3,0,0,10,0,10
251,20127,Halsted St & 111th St,41.69226256,-87.64261186,5,6,1,2,4,4,11,8,3
252,20128,S Wentworth Ave & W 111th St,41.69,-87.63,9,5,9,5,0,0,14,0,14
253,20129,Ada St & 113th St,41.68758464,-87.65539312,14,11,14,11,0,0,25,0,25
254,20130,Wentworth Ave & 104th St,41.70538167,-87.62885783,3,3,3,1,0,0,6,0,4
255,20131,Cottage Grove Ave & 111th Pl,41.691641,-87.61001483,13,8,13,6,0,0,21,0,19
256,20133,Woodlawn & 103rd - Olive Harvey Vaccination Site,41.71,-87.59,6,2,6,2,0,0,8,0,8
257,20134,Maryland Ave & 104th St,41.71,-87.6,6,7,6,7,0,0,13,0,13
258,20201,Kedzie Ave & 104th St,41.7,-87.7,18,9,18,9,0,0,27,0,27
259,20202,W 103rd St & S Avers Ave,41.71,-87.72,61,61,61,61,0,0,122,0,122
260,20203,Lawndale Ave & 111th St,41.69131919,-87.71288574,12,10,4,2,8,8,22,16,6
261,20204,Kedzie Ave & 110th St,41.69239475,-87.70096064,6,5,0,0,6,5,11,11,0
262,20205,Western Ave & 111th St,41.691211,-87.681297,28,10,19,1,8,9,38,17,20
263,20206,Homewood Ave & 115th St,41.68457533,-87.670912,14,13,12,8,2,5,27,7,20
264,20207,Major Taylor Trail & 115th St,41.68496966,-87.64528561,4,6,3,5,1,1,10,2,8
265,20208,Major Taylor Trail & 124th St,41.66869635,-87.63711333,6,4,1,0,5,4,10,9,0
266,20209,S Michigan Ave & E 118th St,41.68,-87.62,7,2,7,2,0,0,9,0,9
267,20210,State St & 123rd St,41.67064384,-87.62258649,6,4,4,3,2,1,10,3,7
268,20211,Eberhart Ave & 131st St,41.65795314,-87.61078382,1,2,1,2,0,0,3,0,3
269,20212,Altgeld Gardens,41.65709388,-87.59889925,6,5,5,4,1,1,11,2,9
270,20213,Commercial Ave & 130th St,41.65915043,-87.5507623,5,5,1,0,2,3,10,5,0
271,20214,Avenue O & 134th St,41.6518678,-87.53967136,8,8,2,3,3,2,16,5,5
272,20215,Hegewisch Metra Station,41.64850076,-87.54608989,9,7,8,4,1,3,16,4,12
273,20217,Torrence Ave & 126th Pl,41.66631201,-87.55721569,7,4,0,0,7,4,11,11,0
274,20218,Avenue O & 118th St,41.68102,-87.53806383,9,7,8,4,1,3,16,4,12
275,20219,Burnham Greenway & 112th St,41.691774,-87.530431,18,17,4,5,7,6,35,13,9
276,20220,Avenue L & 114th St,41.69,-87.54,13,0,13,0,0,0,0,0,0
277,20221,Torrence Ave & 106th St,41.70280085,-87.55972624,5,2,2,0,3,2,7,5,0
278,20222,Burnham Greenway & 105th St,41.70457509,-87.52823174,7,4,2,1,4,3,11,7,3
279,20223,Ewing Ave & Burnham Greenway,41.71259367,-87.53458133,35,16,23,3,12,13,51,25,26
280,20224,Calumet Park,41.71374309,-87.5308429,43,40,26,25,5,6,83,11,51
281,20225,Commercial Ave & 100th St,41.7133174,-87.55109757,0,0,0,0,0,0,0,0,0
282,20226,Oglesby Ave & 100th St,41.71339748,-87.56584167,4,2,3,1,1,1,6,2,4
283,20227,Bradley Park,41.717878,-87.564592,2,2,0,0,0,0,4,0,0
284,20228,Constance Ave & 95th St,41.72229074,-87.57896841,4,2,2,1,2,1,6,3,3
285,20229,Baltimore Ave & 87th St,41.7373356,-87.5485146,5,5,1,1,4,4,10,8,2
286,20230,Clyde Ave & 87th St,41.73715146,-87.57274032,3,2,0,0,3,2,5,5,0
287,20231,East End Ave & 87th St,41.73681521,-87.58280128,11,6,1,0,10,6,17,16,0
288,20232,Big Marsh Park,41.68587706,-87.57382393,6,6,0,0,6,6,12,12,0
289,20233,Halsted St & 78th St,41.75248701,-87.64390216,8,3,4,1,1,0,11,0,5
290,20234,Ashland Ave & 78th St,41.75219345,-87.6638298,5,2,3,0,2,2,7,4,0
291,20235,Greenwood Ave & 91st St,41.7287415,-87.59728483,5,3,4,2,0,0,8,0,6
292,20236,Stony Island Ave & 90th St,41.73139494,-87.58574367,15,13,6,6,4,3,28,7,12
293,20237,Yates Blvd & 93rd St,41.72616639,-87.56627619,5,4,0,0,5,4,9,9,0
294,20238,Greenwood Ave & 97th St,41.71870315,-87.59703577,2,1,1,0,1,1,3,2,0
295,20239,Marquette Ave & 89th St,41.73366879,-87.55834222,11,11,4,5,7,6,22,13,9
296,20240,Indiana Ave & 133rd St,41.65,-87.62,2,0,2,0,0,0,0,0,0
297,20241,Steelworkers Park,41.74,-87.53,12,10,12,10,0,0,22,0,22
298,20242,Houston Ave & 92nd St,41.72820422,-87.54970014,13,9,5,4,8,5,22,13,9
299,20243,Michigan Ave & 114th St,41.68703389,-87.62110996,4,2,4,0,0,0,6,0,0
300,20244,Halsted St & 73rd St,41.76169443,-87.64409149,6,5,4,3,2,2,11,4,7
301,20245,Ashland Ave & 74th St,41.75923602,-87.66347408,6,10,4,4,2,5,16,7,8
302,20246,N Green St & W Lake St,41.89,-87.65,291,259,291,259,0,0,550,0,550
303,20247,W Washington Blvd & N Peoria St,41.88,-87.65,56,29,56,29,0,0,85,0,85
304,202480,Hampden Ct & Diversey Ave,41.93,-87.64,162,152,162,152,0,0,314,0,314
305,20249,N Clark St & W Elm St,41.9,-87.63,4,4,4,4,0,0,8,0,8
306,20251,N Carpenter St & W Lake St,41.89,-87.65,131,135,131,135,0,0,266,0,266
307,20252,W Oakdale Ave & N Broadway,41.94,-87.64,119,103,119,103,0,0,222,0,222
308,20253,N Paulina St & Lincoln Ave,41.94,-87.67,33,21,33,21,0,0,54,0,54
309,20254,W Armitage Ave & N Sheffield Ave,41.92,-87.65,119,111,119,111,0,0,230,0,230
310,20255,N Damen Ave & W Chicago Ave,41.9,-87.68,29,21,29,21,0,0,50,0,50
311,20256,N Sheffield Ave & W Wellington Ave,41.94,-87.65,54,47,54,47,0,0,101,0,101
312,20257,N Southport Ave & W Newport Ave,41.94,-87.66,44,33,44,33,0,0,77,0,77
313,20260,Ping Tom Park (East),41.86,-87.63,2,3,2,3,0,0,5,0,5
314,21544,State St & Chicago Ave,41.89653317,-87.628655,667,587,273,245,378,319,1254,697,518
315,301,Monticello Ave & Chicago Ave,41.9,-87.72,8,3,8,3,0,0,11,0,11
316,302,Lamon Ave & Chicago Ave,41.9,-87.75,11,3,11,3,0,0,14,0,14
317,303,Kildare Ave & Division St,41.9,-87.73,16,14,16,14,0,0,30,0,30
318,304,Lavergne Ave & Division St,41.9,-87.75,5,4,5,4,0,0,9,0,9
319,305,Menard Ave & Division St,41.9,-87.77,9,5,9,5,0,0,14,0,14
320,307,Leamington Ave & Hirsch St,41.91,-87.75,7,5,7,5,0,0,12,0,12
321,308,Major Ave & Bloomingdale Ave,41.91,-87.77,3,2,3,2,0,0,5,0,5
322,309,Narragansett & McLean,41.92,-87.79,14,13,14,13,0,0,27,0,27
323,310,North Ave & New England Ave,41.91,-87.8,4,3,4,3,0,0,7,0,7
324,312,Lockwood Ave & Wrightwood Ave,41.93,-87.76,32,24,32,24,0,0,56,0,56
325,313,Long Ave & Belden Ave,41.92,-87.76,20,11,20,11,0,0,31,0,31
326,314,Narragansett & Wrightwood,41.93,-87.79,30,27,30,27,0,0,57,0,57
327,316,Lamon Ave & Belmont Ave,41.94,-87.75,45,28,45,28,0,0,73,0,73
328,317,Long Ave & Belmont Ave,41.94,-87.76,18,11,18,11,0,0,29,0,29
329,318,Oak Park & Wellington,41.93,-87.8,26,11,26,11,0,0,37,0,37
330,319,Roscoe & Harlem,41.94,-87.81,9,2,9,2,0,0,11,0,11
331,320,Orange & Addison,41.94,-87.82,38,35,38,35,0,0,73,0,73
332,321,Kostner Ave & Wrightwood Ave,41.93,-87.74,43,21,43,21,0,0,64,0,64
333,322,Cicero Ave & Grace St,41.95,-87.75,8,3,8,3,0,0,11,0,11
334,323,Narragansett & Irving Park,41.95,-87.79,29,25,29,25,0,0,54,0,54
335,324,Meade Ave & Addison St,41.95,-87.78,22,19,22,19,0,0,41,0,41
336,325,Harlem Ave & Grace St,41.95,-87.81,11,6,11,6,0,0,17,0,17
337,326,Harlem & Irving Park,41.95,-87.81,43,28,43,28,0,0,71,0,71
338,327,Plainfield & Irving Park,41.95,-87.83,7,5,7,5,0,0,12,0,12
339,329,Central Park Ave & Douglas Blvd,41.86,-87.72,7,3,7,3,0,0,10,0,10
340,330,Keeler Ave & Roosevelt Rd,41.87,-87.73,4,1,4,1,0,0,5,0,5
341,331,Halsted St & Clybourn Ave,41.90963467,-87.64813667,945,973,416,409,521,550,1918,1071,825
342,332,Harding Ave & 26th St,41.84,-87.72,9,7,9,7,0,0,16,0,16
343,333,Kildare & Cermak,41.85,-87.73,10,5,10,5,0,0,15,0,15
344,334,Lawndale Ave & 30th St,41.84,-87.72,7,2,7,2,0,0,9,0,9
345,335,Komensky Ave & 31st St,41.84,-87.73,35,29,35,29,0,0,64,0,64
346,336,La Villita Park (Albany/30th),41.84,-87.7,16,10,16,10,0,0,26,0,26
347,337,Hoyne Ave & 34th St,41.83,-87.68,2,1,2,1,0,0,3,0,3
348,338,California Ave & 36th St,41.83,-87.69,7,4,7,4,0,0,11,0,11
349,339,Sacramento Ave & Pershing Rd,41.82,-87.7,5,8,5,8,0,0,13,0,13
350,340,Pulaski & Ann Lurie Pl,41.82,-87.72,4,3,4,3,0,0,7,0,7
351,341,Archer Ave & 43rd St,41.82,-87.7,10,12,10,12,0,0,22,0,22
352,342,Kedzie Ave & 45th St,41.81,-87.7,13,4,13,4,0,0,17,0,17
353,343,Pulaski Rd & 51st St,41.8,-87.72,55,38,55,38,0,0,93,0,93
354,344,Springfield Ave & 47th St,41.81,-87.72,11,6,11,6,0,0,17,0,17
355,345,Artesian Ave & 55th St,41.79,-87.69,19,15,19,15,0,0,34,0,34
356,346,Kedzie Ave & 57th St,41.79,-87.7,15,11,15,11,0,0,26,0,26
357,347,Komensky Ave & 55th St,41.79,-87.72,4,0,4,0,0,0,0,0,0
358,348,Western Ave & 62nd St,41.78,-87.68,5,4,5,4,0,0,9,0,9
359,349,Spaulding Ave & 63rd St,41.78,-87.71,2,3,2,3,0,0,5,0,5
360,350,Hamlin Ave & 62nd Pl,41.78,-87.72,10,7,10,7,0,0,17,0,17
361,351,Mulligan Ave & Wellington Ave,41.93,-87.78,22,17,22,17,0,0,39,0,39
362,352,Sayre & Diversey,41.93,-87.8,14,7,14,7,0,0,21,0,21
363,353,Meade Ave & Diversey Ave,41.93,-87.78,12,2,12,2,0,0,14,0,14
364,354,Parkside Ave & Armitage Ave,41.92,-87.77,3,0,3,0,0,0,0,0,0
365,355,Central Ave & Parker Ave,41.93,-87.77,13,4,13,4,0,0,17,0,17
366,356,Lavergne & Fullerton,41.92,-87.75,20,16,20,16,0,0,36,0,36
367,357,Lamon Ave & Armitage Ave,41.92,-87.75,6,2,6,2,0,0,8,0,8
368,358,Kilpatrick Ave & Parker Ave,41.93,-87.74,28,12,28,12,0,0,40,0,40
369,359,Kilbourn & Belden,41.92,-87.74,41,21,41,21,0,0,62,0,62
370,360,Kilbourn & Roscoe,41.94,-87.74,13,11,13,11,0,0,24,0,24
371,361,Kenosha & Wellington,41.93,-87.73,20,18,20,18,0,0,38,0,38
372,362,Lawndale Ave & 16th St,41.86,-87.72,7,1,7,1,0,0,8,0,8
373,363,Tripp Ave & 15th St,41.86,-87.73,1,0,1,0,0,0,0,0,0
374,364,Homan Ave & Fillmore St,41.87,-87.71,9,2,9,2,0,0,11,0,11
375,365,Kildare Ave & 26th St,41.84,-87.73,6,2,6,2,0,0,8,0,8
376,366,Spaulding Ave & 16th St,41.86,-87.71,12,10,12,10,0,0,22,0,22
377,367,Mayfield & Roosevelt Rd,41.87,-87.77,6,4,6,4,0,0,10,0,10
378,368,Tripp Ave & 31st St,41.84,-87.73,6,4,6,4,0,0,10,0,10
379,369,Central Park Ave & Ohio St,41.89,-87.72,24,12,24,12,0,0,36,0,36
380,370,Central Park & Augusta Blvd,41.9,-87.72,9,8,9,8,0,0,17,0,17
381,371,Kildare Ave & Chicago Ave,41.9,-87.73,9,3,9,3,0,0,12,0,12
382,373,Augusta Blvd & Laramie Ave,41.9,-87.76,2,1,2,1,0,0,3,0,3
383,374,Kilpatrick Ave & Grand Ave,41.91,-87.74,13,2,13,2,0,0,15,0,15
384,375,Long Ave & North Ave,41.91,-87.76,4,3,4,3,0,0,7,0,7
385,376,Menard Ave & North Ave,41.91,-87.77,3,1,3,1,0,0,4,0,4
386,377,Bloomingdale Ave & Harlem Ave,41.91,-87.81,7,3,7,3,0,0,10,0,10
387,378,Nordica & Medill,41.92,-87.8,11,7,11,7,0,0,18,0,18
388,379,Rockwell St & Archer Ave,41.82,-87.69,22,9,22,9,0,0,31,0,31
389,380,Fairfield Ave & 44th St,41.81,-87.69,2,0,2,0,0,0,0,0,0
390,381,Francisco Ave & 47th St,41.81,-87.7,17,16,17,16,0,0,33,0,33
391,382,Kedzie Ave & 48th Pl,41.8,-87.7,69,42,69,42,0,0,111,0,111
392,383,Campbell Ave & 51st St,41.8,-87.69,13,8,13,8,0,0,21,0,21
393,384,Kedzie Ave & 52nd St,41.8,-87.7,19,7,19,7,0,0,26,0,26
394,385,St Louis Ave & Norman Bobbins Ave,41.79,-87.71,9,6,9,6,0,0,15,0,15
395,386,Rockwell St & 57th St,41.79,-87.69,10,4,10,4,0,0,14,0,14
396,387,St Louis Ave & 59th St,41.79,-87.71,12,10,12,10,0,0,22,0,22
397,388,Richmond St & 59th St,41.79,-87.7,4,2,4,2,0,0,6,0,6
398,389,Maplewood Ave & 59th St,41.79,-87.69,8,6,8,6,0,0,14,0,14
399,390,California Ave & Marquette Rd,41.77,-87.69,5,2,5,2,0,0,7,0,7
400,391,Rockwell St & 63rd St,41.78,-87.69,4,2,4,2,0,0,6,0,6
401,392,Homan Ave & 65th St,41.78,-87.71,14,17,14,17,0,0,31,0,31
402,393,Oketo Ave & Addison St,41.94,-87.81,6,3,6,3,0,0,9,0,9
403,394,Panama Ave & Grace St,41.95,-87.83,7,2,7,2,0,0,9,0,9
404,395,Shabbona Park,41.94,-87.8,12,8,12,8,0,0,20,0,20
405,396,Central Ave & Roscoe St,41.94,-87.77,31,20,31,20,0,0,51,0,51
406,397,Narragansett Ave & School St,41.94,-87.79,12,6,12,6,0,0,18,0,18
407,398,Long & Irving Park,41.95,-87.76,23,17,23,17,0,0,40,0,40
408,399,Lavergne Ave & 46th St,41.81,-87.75,9,10,9,10,0,0,19,0,19
409,400,Lawler Ave & 50th St,41.8,-87.75,21,21,21,21,0,0,42,0,42
410,401,Kildare Ave & 47th St,41.81,-87.73,4,3,4,3,0,0,7,0,7
411,402,Kenneth Ave & 50th St,41.8,-87.73,14,9,14,9,0,0,23,0,23
412,403,Kildare Ave & 55th St,41.79,-87.73,2,0,2,0,0,0,0,0,0
413,404,Pulaski Rd & 60th St,41.78,-87.72,12,3,12,3,0,0,15,0,15
414,406,Kostner Ave & 63rd St,41.78,-87.73,4,3,4,3,0,0,7,0,7
415,407,Tripp Ave & 65th St,41.77,-87.73,21,12,21,12,0,0,33,0,33
416,414,Sacramento Blvd & Fulton Ave,41.89,-87.7,14,8,14,8,0,0,22,0,22
417,415,Western Ave & Lake St,41.88,-87.69,7,7,7,7,0,0,14,0,14
418,416,Washtenaw Ave & Madison St,41.88,-87.69,11,6,11,6,0,0,17,0,17
419,418,Mozart St & Jackson Blvd,41.88,-87.7,4,4,4,4,0,0,8,0,8
420,419,Sacramento Blvd & Polk St,41.87,-87.7,8,5,8,5,0,0,13,0,13
421,420,Washtenaw Ave & Polk St,41.87,-87.69,15,11,15,11,0,0,26,0,26
422,421,Albany Ave & Douglas Blvd,41.86,-87.7,6,8,6,8,0,0,14,0,14
423,422,Albany Ave & 16th St,41.86,-87.7,8,1,8,1,0,0,9,0,9
424,424,Sacramento Ave & 25th St,41.85,-87.7,4,3,4,3,0,0,7,0,7
425,425,Rockwell St & Cermak Rd,41.85,-87.69,35,30,35,30,0,0,65,0,65
426,426,California & 16th St,41.86,-87.7,19,8,19,8,0,0,27,0,27
427,427,Whipple St & Roosevelt Rd,41.87,-87.7,3,1,3,1,0,0,4,0,4
428,428,Milwaukee Ave & Fullerton Ave,41.92,-87.7,84,70,84,70,0,0,154,0,154
429,429,Francisco Ave & Bloomingdale Ave,41.91,-87.7,29,21,29,21,0,0,50,0,50
430,430,Troy St & Grace St,41.95,-87.71,36,32,36,32,0,0,68,0,68
431,431,Western Ave & Grace St,41.95,-87.69,29,19,29,19,0,0,48,0,48
432,432,Sacramento Blvd & Addison St,41.95,-87.7,35,28,35,28,0,0,63,0,63
433,433,Elston Ave & Henderson St,41.94,-87.7,19,14,19,14,0,0,33,0,33
434,434,Albany Ave & Belmont Ave,41.94,-87.71,47,45,47,45,0,0,92,0,92
435,435,Rockwell St & Fletcher St,41.94,-87.69,39,35,39,35,0,0,74,0,74
436,436,Kedzie Ave & George St,41.93,-87.71,82,64,82,64,0,0,146,0,146
437,439,Campbell Ave & Irving Park Rd,41.95,-87.69,11,4,11,4,0,0,15,0,15
438,441,Virginia Ave & Catalpa Ave,41.98,-87.7,15,12,15,12,0,0,27,0,27
439,442,Lincoln Ave & Balmoral Ave,41.98,-87.69,48,47,48,47,0,0,95,0,95
440,443,California Ave & Winona St,41.97,-87.7,45,37,45,37,0,0,82,0,82
441,444,N Shore Channel Trail & Argyle St,41.97,-87.7,23,21,23,21,0,0,44,0,44
442,445,Western Ave & Gunnison St,41.97,-87.69,22,20,22,20,0,0,42,0,42
443,446,Francisco Ave & Montrose Ave,41.96,-87.7,4,1,4,1,0,0,5,0,5
444,452,Richmond St & Lincoln Ave,41.99,-87.7,10,5,10,5,0,0,15,0,15
445,458,Washtenaw Ave & Peterson Ave,41.99,-87.7,7,3,7,3,0,0,10,0,10
446,460,Francisco Ave & Hollywood Ave,41.98,-87.7,2,0,2,0,0,0,0,0,0
447,462,Lincoln Ave & Peterson Ave,41.99,-87.71,23,16,23,16,0,0,39,0,39
448,464,Western Ave & Ardmore Ave,41.99,-87.69,14,13,14,13,0,0,27,0,27
449,465,Troy Ave & 27th St,41.84,-87.7,1,1,1,1,0,0,2,0,2
450,466,California Ave & 29th St,41.84,-87.69,1,2,1,2,0,0,3,0,3
451,471,Damen Ave & 33rd St,41.83,-87.68,9,2,9,2,0,0,11,0,11
452,472,Elston Ave & George St,41.93,-87.69,25,24,25,24,0,0,49,0,49
453,473,Mason Ave & Belmont Ave,41.94,-87.77,9,5,9,5,0,0,14,0,14
454,474,Fullerton & Monitor,41.92,-87.77,19,11,19,11,0,0,30,0,30
455,475,Whipple/Irving Park,41.95,-87.7,12,9,12,9,0,0,21,0,21
456,514,Ridge Blvd & Howard St,42.019276,-87.68452,52,24,13,5,38,18,76,56,18
457,515,Paulina St & Howard St,42.019159,-87.673573,138,147,34,34,97,110,285,207,68
458,517,Clark St & Jarvis Ave,42.015963,-87.675005,76,73,25,19,50,52,149,102,44
459,518,Conservatory Dr & Lake St,41.885502,-87.716866,71,57,45,37,25,17,128,42,82
460,519,Wolcott Ave & Fargo Ave,42.01691083,-87.677642,36,29,21,17,15,12,65,27,38
461,520,Greenview Ave & Jarvis Ave,42.015962,-87.66857,154,147,39,39,110,108,301,218,78
462,523,Eastlake Ter & Rogers Ave,42.02089012,-87.66504002,93,89,41,41,47,44,182,91,82
463,525,Glenwood Ave & Touhy Ave,42.012701,-87.666058,111,105,20,20,89,79,216,168,40
464,527,Western Ave & Howard St,42.01893017,-87.69012417,56,55,25,26,31,27,111,58,51
465,528,Pulaski Rd & Lake St,41.885409,-87.726491,10,9,7,7,3,2,19,5,14
466,530,Laramie Ave & Kinzie St,41.887832,-87.755527,5,6,1,2,2,2,11,4,3
467,534,Karlov Ave & Madison St,41.88085,-87.727907,5,5,3,3,2,2,10,4,6
468,535,Pulaski Rd & Congress Pkwy,41.874325,-87.725704,17,10,12,7,5,3,27,8,19
469,536,Kostner Ave & Lake St,41.88594033,-87.73529283,4,3,2,2,2,1,7,3,4
470,537,Kenton Ave & Madison St,41.88069083,-87.74108383,3,4,2,3,1,1,7,2,5
471,540,Laramie Ave & Madison St,41.880235,-87.75541983,9,5,3,1,5,2,14,7,4
472,543,Laramie Ave & Gladys Ave,41.875806,-87.755285,6,4,3,2,1,2,10,3,5
473,545,Kostner Ave & Adams St,41.877917,-87.735737,4,2,0,0,4,1,6,5,0
474,546,Damen Ave & Pershing Rd,41.823192,-87.676597,29,30,16,15,10,12,59,22,31
475,549,Marshfield Ave & 44th St,41.81401098,-87.66658664,50,51,45,42,5,9,101,14,87
476,553,Elizabeth St & 47th St,41.80839,-87.656526,2,3,1,1,1,2,5,3,2
477,554,Damen Ave & 51st St,41.800908,-87.674684,7,8,3,4,4,4,15,8,7
478,556,Throop St & 52nd St,41.799659,-87.657195,4,3,1,2,2,1,7,3,3
479,557,Seeley Ave & Garfield Blvd,41.794087,-87.675478,1,6,0,0,0,0,7,0,0
480,559,Racine Ave & Garfield Blvd,41.794228,-87.655073,13,11,5,5,7,6,24,13,10
481,560,Marshfield Ave & 59th St,41.786833,-87.666215,5,4,0,0,5,4,9,9,0
482,561,Damen Ave & 59th St,41.78598183,-87.674166,8,7,1,1,5,4,15,9,2
483,562,Racine Ave & 61st St,41.783189,-87.654372,3,5,0,0,2,3,8,5,0
484,564,Racine Ave & 65th St,41.775378,-87.65431967,1,1,1,1,0,0,2,0,2
485,567,May St & 69th St,41.768938,-87.652934,10,7,4,3,6,4,17,10,7
486,569,Woodlawn Ave & 75th St,41.75916,-87.595751,4,3,3,2,1,1,7,2,5
487,570,Evans Ave & 75th St,41.75849,-87.60641,8,8,1,0,5,2,16,7,0
488,571,Vernon Ave & 75th St,41.758361,-87.614138,18,10,4,3,4,0,28,0,7
489,572,State St & 76th St,41.756971,-87.624621,2,3,0,0,1,2,5,3,0
490,573,State St & 79th St,41.750794,-87.624424,19,23,7,6,9,6,42,15,13
491,574,Vernon Ave & 79th St,41.75094,-87.61379,7,6,0,0,0,0,13,0,0
492,575,Cottage Grove Ave & 78th St,41.75316517,-87.60503883,6,6,2,2,1,2,12,3,4
493,576,Greenwood Ave & 79th St,41.751294,-87.597552,6,4,2,2,4,2,10,6,4
494,577,Stony Island Ave & South Chicago Ave,41.751173,-87.585337,2,3,0,0,2,2,5,4,0
495,579,Phillips Ave & 79th St,41.7518355,-87.56518783,36,30,17,13,18,15,66,33,30
496,580,Exchange Ave & 79th St,41.751731,-87.552812,9,5,0,0,8,5,14,13,0
497,582,Phillips Ave & 83rd St,41.74455845,-87.5651474,16,11,15,9,1,2,27,3,24
498,583,Stony Island Ave & 82nd St,41.746559,-87.586005,16,10,11,5,5,5,26,10,16
499,584,Ellis Ave & 83rd St,41.744123,-87.599034,3,2,0,0,3,2,5,5,0
500,585,Cottage Grove Ave & 83rd St,41.743441,-87.604836,11,12,5,3,5,8,23,13,8
501,586,MLK Jr Dr & 83rd St,41.743116,-87.6148,15,15,0,0,8,8,30,16,0
502,587,Wabash Ave & 83rd St,41.743316,-87.622849,6,5,5,3,1,2,11,3,8
503,588,South Chicago Ave & 83rd St,41.74392045,-87.57519305,9,7,5,5,3,2,16,5,10
504,590,Kilbourn Ave & Irving Park Rd,41.953733,-87.740569,19,20,6,6,13,13,39,26,12
505,592,Knox Ave & Montrose Ave,41.960631,-87.745359,24,17,14,12,10,5,41,15,26
506,593,Halsted St & 59th St,41.787539,-87.644874,3,3,0,0,3,2,6,5,0
507,594,Western Blvd & 48th Pl,41.805661,-87.683392,20,26,11,11,5,9,46,14,22
508,595,Wabash Ave & 87th St,41.73661333,-87.62261783,18,16,9,7,5,8,34,13,16
509,596,Benson Ave & Church St,42.048238,-87.683539,298,317,105,105,188,200,615,388,210
510,598,Elmwood Ave & Austin St,42.02576317,-87.68410883,57,58,24,27,29,26,115,55,51
511,599,Valli Produce - Evanston Plaza,42.039742,-87.699413,44,39,30,31,14,8,83,22,61
512,600,Dodge Ave & Church St,42.048308,-87.698224,68,55,17,19,51,36,123,87,36
513,604,Sheridan Rd & Noyes St (NU),42.058239,-87.677432,334,346,118,115,206,226,680,432,233
514,605,University Library (NU),42.052939,-87.673447,187,196,35,40,136,145,383,281,75
515,620,Orleans St & Chestnut St (NEXT Apts),41.898203,-87.637536,528,450,211,186,312,260,978,572,397
516,623,Michigan Ave & 8th St,41.872773,-87.623981,715,666,220,204,429,380,1381,809,424
517,624,Dearborn St & Van Buren St,41.87633741,-87.62917364,516,405,211,170,285,222,921,507,381
518,631,Malcolm X College Vaccination Site,41.877618,-87.673895,121,127,56,60,58,61,248,119,116
519,632,Clark St & Newport St,41.94454,-87.654678,893,845,371,350,501,480,1738,981,721
520,636,Orleans St & Hubbard St,41.88998833,-87.63682917,556,531,281,268,272,261,1087,533,549
521,637,Wood St & Chicago Ave,41.895634,-87.672069,380,386,131,133,241,243,766,484,264
522,638,Clinton St & Jackson Blvd,41.87831661,-87.64098108,1189,1078,489,444,688,623,2267,1311,933
523,639,Lakefront Trail & Wilson Ave,41.965845,-87.645361,349,321,80,70,232,223,670,455,150
524,642,Latrobe Ave & Chicago Ave,41.894745,-87.756895,6,5,1,1,5,4,11,9,2
525,643,Smith Park,41.892106,-87.68937817,132,133,102,98,29,29,265,58,200
526,644,Western Ave & Fillmore St,41.86865067,-87.68623533,262,275,166,165,95,108,537,203,331
527,646,State St & 54th St,41.796642,-87.625923,8,7,5,5,3,2,15,5,10
528,647,Elizabeth St & 59th St,41.78987217,-87.6547145,1,0,1,0,0,0,0,0,0
529,649,Stewart Ave & 63rd St,41.779835,-87.634774,6,14,2,3,4,11,20,15,5
530,650,Eggleston Ave & 69th St,41.768898,-87.635876,11,3,8,1,2,2,14,4,9
531,651,Michigan Ave & 71st St,41.765286,-87.621748,4,5,1,2,1,3,9,4,3
532,652,Rhodes Ave & 71st St,41.76596417,-87.61178733,3,2,2,2,0,0,5,0,4
533,653,Cornell Dr & Hayes Dr,41.780595,-87.584846,22,25,5,5,11,18,47,29,10
534,654,Racine Ave & Washington Blvd,41.883073,-87.656952,297,291,130,124,155,159,588,314,254
535,655,Hoyne Ave & Balmoral Ave,41.97984883,-87.68190567,128,129,87,92,40,36,257,76,179
536,657,Wood St & Augusta Blvd,41.899181,-87.6722,288,258,129,118,159,140,546,299,247
537,658,Leavitt St & Division St,41.902997,-87.683825,228,206,82,80,141,125,434,266,162
538,660,Sheridan Rd & Columbia Ave,42.004554,-87.66152467,186,195,64,69,111,119,381,230,133
539,661,Evanston Civic Center,42.057044,-87.686554,98,92,27,29,68,56,190,124,56
540,662,Dodge Ave & Mulford St,42.023463,-87.699595,22,26,1,1,19,25,48,44,2
541,665,South Chicago Ave & Elliot Ave,41.747363,-87.580046,5,3,4,2,0,0,8,0,6
542,Bissell St & Armitage Ave - Charging,Bissell St & Armitage Ave - Charging,41.91849683,-87.6522475,19,19,6,6,13,13,38,26,12
543,DIVVY 001,WEST CHI-WATSON,41.9448345,-87.79937667,5,0,5,0,0,0,0,0,0
544,E002,Chicago Ave & Washington St,42.03256655,-87.67928386,161,157,67,70,88,80,318,168,137
545,E006,Central St Metra,42.063598,-87.69873,66,73,25,27,38,46,139,84,52
546,E007,Central St & Girard Ave,42.06427933,-87.68611117,43,46,16,18,26,26,89,52,34
547,E008,Chicago Ave & Sheridan Rd,42.050491,-87.677821,275,279,78,79,185,182,554,367,157
548,E011,Dodge Ave & Main St,42.03463185,-87.6991877,24,24,14,14,10,10,48,20,28
549,E014,Lincolnwood Dr & Central St,42.064854,-87.715297,26,26,2,4,23,21,52,44,6
550,Hastings WH 2,Hastings WH 2,41.86309433,-87.67972875,2,1,2,1,0,0,3,0,3
551,Hubbard Bike-checking (LBS-WH-TEST),Base - 2132 W Hubbard Warehouse,41.8592695,-87.69549867,108,11,108,2,0,0,119,0,110
552,KA1503000001,Shields Ave & 43rd St,41.81629455,-87.63474834,3,3,2,2,1,1,6,2,4
553,KA1503000002,South Shore Dr & 71st St,41.766409,-87.565688,75,71,44,41,24,28,146,52,85
554,KA1503000003,Cottage Grove Ave & 71st St,41.76571904,-87.60495971,7,7,0,0,7,5,14,12,0
555,KA1503000004,Lake Park Ave & 35th St,41.83127424,-87.60879919,121,116,32,33,74,66,237,140,65
556,KA1503000005,Wentworth Ave & 35th St,41.830777,-87.632504,70,53,33,22,34,28,123,62,55
557,KA1503000007,Cornell Ave & Hyde Park Blvd,41.802406,-87.586924,489,424,154,135,312,272,913,584,289
558,KA1503000009,Princeton Ave & 47th St,41.80931771,-87.63344929,28,30,11,11,15,18,58,33,22
559,KA1503000010,Halsted St & 51st St,41.80183164,-87.6452139,5,4,0,0,5,2,9,7,0
560,KA1503000011,Halsted St & 56th St,41.793072,-87.64502417,4,5,4,3,0,0,9,0,7
561,KA1503000012,Clark St & Lake St,41.88604808,-87.63125217,731,753,273,278,443,447,1484,890,551
562,KA1503000013,Princeton Ave & Garfield Blvd,41.794982,-87.633124,25,17,10,9,14,5,42,19,19
563,KA1503000014,Ellis Ave & 60th St,41.78509715,-87.60107276,1629,1558,413,392,1211,1154,3187,2365,805
564,KA1503000015,Wabash Ave & Adams St,41.87947235,-87.62568861,607,624,254,246,324,346,1231,670,500
565,KA1503000018,Jeffery Blvd & 71st St,41.76663824,-87.57645011,10,13,1,1,9,10,23,19,2
566,KA1503000019,Stony Island Ave & 75th St,41.75866967,-87.58688287,20,21,9,9,11,12,41,23,18
567,KA1503000020,South Shore Dr & 74th St,41.76218896,-87.55927465,25,24,8,7,17,16,49,33,15
568,KA1503000021,Stony Island Ave & 64th St,41.778881,-87.586647,15,9,10,5,4,3,24,7,15
569,KA1503000022,Clark St & Montrose Ave,41.96154333,-87.66618367,302,248,126,129,174,115,550,289,255
570,KA1503000023,Stony Island Ave & 67th St,41.7734585,-87.58533974,24,20,15,7,7,11,44,18,22
571,KA1503000024,Yates Blvd & 75th St,41.758768,-87.56644,18,20,1,1,13,15,38,28,2
572,KA1503000025,Wentworth Ave & 63rd St,41.78007963,-87.62974631,22,11,6,6,12,5,33,17,12
573,KA1503000027,Prairie Ave & 43rd St,41.81665889,-87.61941246,39,31,12,12,26,19,70,45,24
574,KA1503000028,Jeffery Blvd & 76th St,41.75712007,-87.57583936,9,6,0,0,9,6,15,15,0
575,KA1503000029,South Shore Dr & 67th St,41.773643,-87.567514,52,45,13,14,35,24,97,59,27
576,KA1503000030,Jeffery Blvd & 67th St,41.77351755,-87.57714283,23,22,10,10,12,11,45,23,20
577,KA1503000031,Cottage Grove Ave & 67th St,41.77372095,-87.60563486,29,18,15,7,14,9,47,23,22
578,KA1503000032,Union Ave & Root St,41.819102,-87.643278,19,25,9,10,10,15,44,25,19
579,KA1503000033,Eberhart Ave & 61st St,41.78414169,-87.61330783,24,21,18,17,6,4,45,10,35
580,KA1503000034,LaSalle St & Adams St,41.87934437,-87.63198522,336,344,102,91,217,249,680,466,193
581,KA1503000038,Shields Ave & 31st St,41.838464,-87.635406,151,145,27,27,118,117,296,235,54
582,KA1503000040,Loomis St & Archer Ave,41.84163254,-87.65743495,56,64,29,31,26,32,120,58,60
583,KA1503000041,McClurg Ct & Erie St,41.89486667,-87.61804533,923,1015,371,373,523,619,1938,1142,744
584,KA1503000043,Kingsbury St & Kinzie St,41.88917683,-87.63850577,2084,1977,850,810,1220,1148,4061,2368,1660
585,KA1503000044,Rush St & Hubbard St,41.890173,-87.626185,487,492,197,197,269,279,979,548,394
586,KA1503000045,Stony Island Ave & 71st St,41.76648367,-87.58646283,25,28,12,13,11,13,53,24,25
587,KA1503000046,Dorchester Ave & 63rd St,41.78040565,-87.59141599,50,44,21,17,27,25,94,52,38
588,KA1503000047,Perry Ave & 69th St,41.76929309,-87.62819593,9,4,2,2,5,2,13,7,4
589,KA1503000049,Rainbow Beach,41.757871,-87.549386,14,15,0,0,10,13,29,23,0
590,KA1503000051,Halsted St & 47th Pl,41.80818433,-87.64564617,41,45,35,37,6,8,86,14,72
591,KA1503000052,Ellis Ave & 53rd St,41.79933626,-87.60095811,302,276,58,57,237,214,578,451,115
592,KA1503000053,MLK Jr Dr & 63rd St,41.78009767,-87.61588433,28,21,15,10,12,9,49,21,25
593,KA1503000054,Cottage Grove Ave & 63rd St,41.780601,-87.605836,53,56,22,22,29,27,109,56,44
594,KA1503000055,Halsted & 63rd - Kennedy-King Vaccination Site,41.77938114,-87.64462081,18,8,9,5,9,3,26,12,14
595,KA1503000059,Lake Park Ave & 53rd St,41.79958867,-87.58635317,294,301,97,98,189,197,595,386,195
596,KA1503000064,Dusable Harbor,41.886976,-87.612813,720,717,172,166,420,436,1437,856,338
597,KA1503000065,Woodlawn Ave & Lake Park Ave,41.8140955,-87.59700467,78,68,26,20,46,46,146,92,46
598,KA1503000066,Wood St & 35th St,41.8301425,-87.67031367,72,66,44,44,27,22,138,49,88
599,KA1503000068,Leavitt St & Archer Ave,41.82879202,-87.68060446,49,36,20,14,23,16,85,39,34
600,KA1503000069,Dorchester Ave & 49th St,41.805772,-87.592464,70,58,18,16,47,37,128,84,34
601,KA1503000070,Harper Ave & 59th St,41.78794281,-87.58831517,292,288,63,63,225,217,580,442,126
602,KA1503000071,University Ave & 57th St,41.791478,-87.599861,1724,1770,403,374,1311,1373,3494,2684,777
603,KA1503000072,Wacker Dr & Washington St,41.88314336,-87.63724208,645,651,278,273,359,365,1296,724,551
604,KA1503000073,MLK Jr Dr & 56th St,41.79342946,-87.61585326,27,13,12,4,15,9,40,24,16
605,KA1503000074,Museum of Science and Industry,41.791728,-87.583945,226,195,51,43,142,133,421,275,94
606,KA1503000075,DuSable Museum,41.79156801,-87.60785218,63,58,19,17,44,40,121,84,36
607,KA1504000076,Ellis Ave & 55th St,41.79430062,-87.60144977,1041,1063,236,229,799,829,2104,1628,465
608,KA1504000078,Lincoln Ave & Winona St,41.97491183,-87.69268983,123,124,78,72,44,49,247,93,150
609,KA1504000079,Larrabee St & Division St,41.90348607,-87.64335349,551,540,214,214,323,321,1091,644,428
610,KA1504000080,Washtenaw Ave & Lawrence Ave,41.9686735,-87.696157,161,160,89,90,64,68,321,132,179
611,KA1504000082,Kedzie Ave & Harrison St,41.87359967,-87.70487075,11,3,5,1,5,1,14,6,6
612,KA1504000086,Kedzie Ave & 24th St,41.848212,-87.70546055,10,14,7,7,3,4,24,7,14
613,KA1504000090,St. Louis Ave & Fullerton Ave,41.92482829,-87.7145319,159,156,89,86,58,61,315,119,175
614,KA1504000091,Hoyne Ave & 47th St,41.808227,-87.67718,23,24,9,13,8,11,47,19,22
615,KA1504000093,Rockwell St & Eastwood Ave,41.96582383,-87.69378483,154,154,77,80,76,70,308,146,157
616,KA1504000096,Sawyer Ave & Irving Park Rd,41.95358618,-87.7093108,57,65,34,34,21,27,122,48,68
617,KA1504000097,Drake Ave & Montrose Ave,41.96115408,-87.71656907,59,54,18,17,39,32,113,71,35
618,KA150400009X,Kimball Ave & Belmont Ave,41.93940767,-87.71161633,114,111,72,73,40,36,225,76,145
619,KA1504000101,Ogden Ave & Roosevelt Rd,41.86651717,-87.68453167,58,58,40,39,18,19,116,37,79
620,KA1504000102,Fairfield Ave & Roosevelt Rd,41.86667067,-87.69456417,44,39,34,29,10,10,83,20,63
621,KA1504000103,Western Ave & Walton St,41.89841769,-87.68659602,324,317,134,130,160,168,641,328,264
622,KA1504000104,Paulina St & Flournoy St,41.87309122,-87.66899621,712,679,270,247,434,429,1391,863,517
623,KA1504000106,Kedzie Ave & Lake St,41.884782,-87.70634817,46,33,33,24,11,6,79,17,57
624,KA1504000109,Washtenaw Ave & Ogden Ave,41.86187833,-87.69355067,57,65,19,19,38,44,122,82,38
625,KA1504000110,Millard Ave & 26th St,41.84453112,-87.715922,28,33,4,4,23,26,61,49,8
626,KA1504000113,Sacramento Blvd & Franklin Blvd,41.89060883,-87.702656,19,22,10,10,9,12,41,21,20
627,KA1504000114,Kedzie Ave & Chicago Ave,41.8954653,-87.70612788,31,36,15,15,16,14,67,30,30
628,KA1504000116,Larrabee St & Oak St,41.90030867,-87.64298767,441,426,191,189,244,232,867,476,380
629,KA1504000117,Halsted St & North Branch St,41.89939029,-87.64854491,114,103,61,55,53,48,217,101,116
630,KA1504000126,Kedzie Ave & Leland Ave,41.96677876,-87.70806181,71,54,44,32,27,22,125,49,76
631,KA1504000127,Manor Ave & Leland Ave,41.96591117,-87.700883,115,115,59,56,53,55,230,108,115
632,KA1504000128,Kedzie Ave & Foster Ave,41.975672,-87.709261,75,79,26,26,37,35,154,72,52
633,KA1504000129,Western Ave & Granville Ave,41.99417663,-87.68943787,65,77,21,21,39,49,142,88,42
634,KA1504000130,Maplewood Ave & Peterson Ave,41.99023603,-87.69336964,36,34,7,6,21,22,70,43,13
635,KA1504000133,Rush St & Cedar St,41.9023087,-87.62769053,862,864,412,407,425,432,1726,857,819
636,KA1504000134,Ritchie Ct & Banks St,41.906866,-87.626217,556,536,255,247,292,271,1092,563,502
637,KA1504000135,Wells St & Elm St,41.903222,-87.634324,1638,1552,613,599,1007,938,3190,1945,1212
638,KA1504000139,Monticello Ave & Irving Park Rd,41.95400484,-87.71912818,85,69,48,39,36,30,154,66,87
639,KA1504000140,Winchester Ave & Elston Ave,41.92409085,-87.67646007,202,225,106,110,93,112,427,205,216
640,KA1504000141,Pulaski Rd & Eddy St (Temp),41.94632117,-87.73115717,19,20,9,7,9,12,39,21,16
641,KA1504000142,Drake Ave & Addison St,41.947326,-87.717582,84,71,51,48,26,18,155,44,99
642,KA1504000143,Leavitt St & Addison St,41.946655,-87.683359,175,168,51,50,122,117,343,239,101
643,KA1504000146,Clark St & Berwyn Ave,41.97803062,-87.66856492,449,497,202,202,235,288,946,523,404
644,KA1504000147,Winchester (Ravenswood) Ave & Balmoral Ave,41.979762,-87.67753,119,137,45,46,72,90,256,162,91
645,KA1504000148,Clark St & Elmdale Ave,41.99086045,-87.66972363,177,160,59,58,115,102,337,217,117
646,KA1504000149,Damen Ave & Foster Ave,41.97569833,-87.679474,220,212,104,106,110,100,432,210,210
647,KA1504000151,Clark St & Bryn Mawr Ave,41.983593,-87.669154,339,367,148,152,182,205,706,387,300
648,KA1504000155,2112 W Peterson Ave,41.99117383,-87.6835785,48,53,30,30,17,23,101,40,60
649,KA1504000156,Clark St & Schreiber Ave,41.99925182,-87.67137734,166,175,72,75,89,97,341,186,147
650,KA1504000158,Oakley Ave & Irving Park Rd,41.954341,-87.68608,118,136,55,53,61,83,254,144,108
651,KA1504000159,Sheridan Rd & Greenleaf Ave,42.01058656,-87.66241209,83,80,13,13,66,61,163,127,26
652,KA1504000160,Francisco Ave & Foster Ave,41.97563273,-87.70141944,107,103,43,42,57,53,210,110,85
653,KA1504000161,St. Louis Ave & Balmoral Ave,41.98035216,-87.716151,65,67,38,38,26,26,132,52,76
654,KA1504000162,Clark St & Lunt Ave,42.00901118,-87.67411172,167,161,88,87,75,71,328,146,175
655,KA1504000164,Keystone Ave & Montrose Ave,41.96110802,-87.7289701,54,53,29,28,24,21,107,45,57
656,KA1504000167,Kedzie Ave & Bryn Mawr Ave,41.98222976,-87.70888656,61,66,31,32,23,25,127,48,63
657,KA1504000168,Western & 28th - Velasquez Institute Vaccination Site,41.8415275,-87.68512,14,11,11,8,3,3,25,6,19
658,KA1504000171,Marine Dr & Ainslie St,41.9716,-87.650154,329,325,132,133,165,160,654,325,265
659,KA1504000175,Glenwood Ave & Morse Ave,42.00798617,-87.66541017,206,197,77,80,124,113,403,237,157
660,KA17018054,Damen Ave & Walnut (Lake) St,41.885951,-87.677009,177,199,89,95,83,102,376,185,184
661,KA17018068,Leavitt St & Belmont Ave,41.93938067,-87.683312,184,200,105,106,77,90,384,167,211
662,KA1706005007,Delano Ct & Roosevelt Rd,41.867491,-87.63219,402,401,171,167,209,209,803,418,338
663,KA1706005015,Kildare Ave & Montrose Ave,41.96102233,-87.7356925,43,37,10,11,25,25,80,50,21
664,KP1705001026,LaSalle Dr & Huron St,41.894877,-87.632326,651,614,251,250,391,353,1265,744,501
665,LF-005,DuSable Lake Shore Dr & North Blvd,41.911722,-87.626804,1226,1227,285,286,836,812,2453,1648,571
666,LP-,Lincoln Park Conservatory,41.92393131,-87.63582453,554,547,150,146,351,342,1101,693,296
667,RN-,Franklin St & Illinois St,41.89102331,-87.63547987,889,789,413,371,468,413,1678,881,784
668,RP-001,Warren Park West,42.001785,-87.688829,34,42,5,5,22,31,76,53,10
669,RP-002,Warren Park East,42.00454962,-87.68066615,67,62,29,25,37,37,129,74,54
670,RP-004,Oakley Ave & Touhy Ave,42.012342,-87.688243,30,35,17,14,13,16,65,29,31
671,RP-005,Western Ave & Lunt Ave,42.00857533,-87.6903255,83,100,48,47,31,49,183,80,95
672,RP-006,Ridge Blvd & Touhy Ave,42.01213228,-87.68291264,39,38,16,14,22,22,77,44,30
673,RP-007,Clark St & Touhy Ave,42.01256012,-87.67436712,79,74,29,29,47,40,153,87,58
674,RP-008,Clark St & Columbia Ave,42.00445063,-87.6724024,159,152,67,68,88,83,311,171,135
675,RP-009,Sheridan Rd & Loyola Ave,42.00104378,-87.66119824,205,204,59,60,131,139,409,270,119
676,SL-005,Indiana Ave & Roosevelt Rd,41.867888,-87.623041,1359,1330,456,441,815,813,2689,1628,897
677,SL-006,Wells St & 19th St,41.85678867,-87.63382867,125,146,50,53,48,71,271,119,103
678,SL-007,State St & Harrison St,41.874053,-87.627716,417,412,140,141,252,239,829,491,281
679,SL-008,Federal St & Polk St,41.87207763,-87.62954377,1094,1050,391,367,683,658,2144,1341,758
680,SL-009,Clark St & 9th St (AMLI),41.870816,-87.631246,405,330,106,83,288,237,735,525,189
681,SL-010,Financial Pl & Ida B Wells Dr,41.87502363,-87.63309404,513,480,214,199,297,279,993,576,413
682,SL-011,Wells St & Polk St,41.872596,-87.633502,704,619,291,261,410,346,1323,756,552
683,SL-012,Wabash Ave & 16th St,41.86026317,-87.6256155,395,390,143,140,250,248,785,498,283
684,SL-013,State St & 19th St,41.85658683,-87.62751283,158,172,55,60,92,102,330,194,115
685,TA1305000001,Wabash Ave & Cermak Rd,41.852619,-87.626488,128,144,46,45,76,91,272,167,91
686,TA1305000002,Wabash Ave & Roosevelt Rd,41.8671985,-87.62591683,1105,1154,397,393,653,706,2259,1359,790
687,TA1305000003,Fairbanks Ct & Grand Ave,41.89241883,-87.6210205,1113,1125,402,404,672,650,2238,1322,806
688,TA1305000004,McCormick Place,41.85137517,-87.61883465,293,283,56,58,191,181,576,372,114
689,TA1305000005,Dearborn St & Adams St,41.87935636,-87.62979104,595,616,238,232,330,355,1211,685,470
690,TA1305000006,Dearborn St & Monroe St,41.88131982,-87.62952092,1181,1154,393,381,747,736,2335,1483,774
691,TA1305000009,Clark St & Ida B Wells Dr,41.87593267,-87.63058454,360,371,99,94,251,268,731,519,193
692,TA1305000010,Michigan Ave & Ida B Wells Dr,41.876243,-87.624426,289,296,100,99,155,168,585,323,199
693,TA1305000011,Michigan Ave & Lake St,41.886024,-87.624117,1208,1208,388,367,742,758,2416,1500,755
694,TA1305000014,Clark St & Wrightwood Ave,41.929546,-87.643118,1090,1068,415,411,659,634,2158,1293,826
695,TA1305000017,Halsted St & Roosevelt Rd,41.86733508,-87.64864683,438,481,158,161,273,310,919,583,319
696,TA1305000020,Ogden Ave & Chicago Ave,41.89628577,-87.65402246,583,589,264,267,305,311,1172,616,531
697,TA1305000022,Orleans St & Merchandise Mart Plaza,41.88807166,-87.6364336,877,872,419,412,450,453,1749,903,831
698,TA1305000025,Franklin St & Jackson Blvd,41.87791622,-87.6351217,1039,1085,439,437,542,605,2124,1147,876
699,TA1305000029,State St & Randolph St,41.88462107,-87.62783423,1012,1040,383,379,591,612,2052,1203,762
700,TA1305000030,Clark St & Randolph St,41.88497,-87.6315655,897,901,397,391,490,504,1798,994,788
701,TA1305000032,Clinton St & Madison St,41.882242,-87.641066,1662,1699,707,724,944,959,3361,1903,1431
702,TA1305000034,Honore St & Division St,41.903119,-87.673935,504,531,253,253,239,272,1035,511,506
703,TA1305000035,State St & Van Buren St,41.877181,-87.627844,468,476,174,173,269,284,944,553,347
704,TA1305000037,Paulina Ave & North Ave,41.91029367,-87.67005867,407,399,173,165,228,227,806,455,338
705,TA1305000039,Elston Ave & Cortland St,41.91643343,-87.66674638,432,449,219,222,207,217,881,424,441
706,TA1305000041,Damen Ave & Pierce Ave,41.90939601,-87.67769193,1087,1089,497,477,560,577,2176,1137,974
707,TA1306000002,Morgan Ave & 14th Pl,41.862378,-87.651062,242,232,78,72,153,152,474,305,150
708,TA1306000003,Desplaines St & Kinzie St,41.88871604,-87.64444785,1204,1071,507,443,684,609,2275,1293,950
709,TA1306000006,Orleans St & Elm St,41.90295367,-87.6377955,193,181,78,77,107,102,374,209,155
710,TA1306000007,Larrabee St & Menomonee St,41.91468,-87.64332,294,284,69,70,215,204,578,419,139
711,TA1306000008,Larrabee St & North Ave,41.91021,-87.6435,345,304,126,122,218,179,649,397,248
712,TA1306000009,Larrabee St & Kingsbury St,41.89767981,-87.6430198,1124,1113,525,511,588,594,2237,1182,1036
713,TA1306000010,Daley Center Plaza,41.884241,-87.629634,1201,1133,465,419,699,691,2334,1390,884
714,TA1306000011,Wells St & Walton St,41.89993001,-87.63443007,584,483,178,151,399,322,1067,721,329
715,TA1306000012,Wells St & Huron St,41.894722,-87.634362,1363,1327,596,603,756,718,2690,1474,1199
716,TA1306000013,New St & Illinois St,41.89084704,-87.61861682,1204,1231,497,490,630,679,2435,1309,987
717,TA1306000014,Wilton Ave & Diversey Pkwy,41.932418,-87.652705,905,931,342,333,551,584,1836,1135,675
718,TA1306000015,Morgan St & Lake St,41.88577925,-87.65102461,985,1130,381,390,587,716,2115,1303,771
719,TA1306000016,Sheffield Ave & Fullerton Ave,41.92549483,-87.653688,1331,1300,475,466,824,807,2631,1631,941
720,TA1306000025,Racine Ave & Congress Pkwy,41.87464,-87.65703,377,305,150,122,222,179,682,401,272
721,TA1306000026,Racine Ave & Fullerton Ave,41.92556258,-87.65840426,816,831,244,253,565,568,1647,1133,497
722,TA1306000029,McClurg Ct & Ohio St,41.892498,-87.6169615,733,768,217,213,469,504,1501,973,430
723,TA1306000032,Sheffield Ave & Willow St,41.913688,-87.652855,573,615,223,226,344,379,1188,723,449
724,TA1307000001,Greenview Ave & Fullerton Ave,41.925425,-87.66579167,517,612,244,260,264,333,1129,597,504
725,TA1307000005,Indiana Ave & 26th St,41.845687,-87.622481,104,105,45,47,58,56,209,114,92
726,TA1307000006,Southport Ave & Wellington Ave,41.93574667,-87.6636355,597,607,232,228,352,372,1204,724,460
727,TA1307000038,Sedgwick St & North Ave,41.911386,-87.638677,823,802,280,274,538,514,1625,1052,554
728,TA1307000039,Clark St & Elm St,41.90310371,-87.63152611,1834,1794,742,731,1069,1048,3628,2117,1473
729,TA1307000041,DuSable Lake Shore Dr & Wellington Ave,41.93668845,-87.63682902,777,808,249,249,509,523,1585,1032,498
730,TA1307000044,Clinton St & 18th St,41.85795,-87.640826,183,177,92,87,87,88,360,175,179
731,TA1307000048,Fort Dearborn Dr & 31st St,41.838556,-87.608218,360,342,44,40,276,255,702,531,84
732,TA1307000052,Sheffield Ave & Wellington Ave,41.93630505,-87.65269232,758,782,288,292,460,472,1540,932,580
733,TA1307000061,State St & Pearson St,41.897448,-87.628722,450,450,160,155,277,282,900,559,315
734,TA1307000062,Sedgwick St & Huron St,41.894666,-87.638437,623,555,246,237,372,313,1178,685,483
735,TA1307000064,Lincoln Ave & Diversey Pkwy,41.932225,-87.658617,853,840,298,296,551,541,1693,1092,594
736,TA1307000066,Damen Ave & Coulter St,41.8492,-87.67564,61,56,30,28,27,25,117,52,58
737,TA1307000070,Damen Ave & Thomas St (Augusta Blvd),41.9014455,-87.6774285,420,373,201,166,214,202,793,416,367
738,TA1307000107,Sheridan Rd & Montrose Ave,41.96154817,-87.65462667,660,666,267,261,375,389,1326,764,528
739,TA1307000111,Franklin St & Lake St,41.885837,-87.6355,974,908,457,411,505,483,1882,988,868
740,TA1307000113,Southport Ave & Wrightwood Ave,41.928849,-87.66381967,528,545,210,209,311,322,1073,633,419
741,TA1307000115,Clybourn Ave & Division St,41.904613,-87.640552,323,333,102,103,215,226,656,441,205
742,TA1307000117,Wabash Ave & Grand Ave,41.89108267,-87.6268315,1495,1471,635,631,805,757,2966,1562,1266
743,TA1307000119,Clarendon Ave & Leland Ave,41.967968,-87.650001,316,299,132,133,172,152,615,324,265
744,TA1307000120,Green St & Madison St,41.881892,-87.648789,1267,1348,581,581,662,743,2615,1405,1162
745,TA1307000121,Halsted St & Polk St,41.87184,-87.64664,790,802,225,219,548,574,1592,1122,444
746,TA1307000124,Michigan Ave & 14th St,41.8642445,-87.62354633,648,612,240,233,391,368,1260,759,473
747,TA1307000126,Sheffield Ave & Waveland Ave,41.949399,-87.654529,795,786,325,317,445,446,1581,891,642
748,TA1307000127,Clark St & Grace St,41.95078,-87.659172,576,540,201,191,368,345,1116,713,392
749,TA1307000128,Dearborn Pkwy & Delaware Pl,41.89874303,-87.62977505,1074,1055,396,393,662,641,2129,1303,789
750,TA1307000129,State St & 35th St,41.83103631,-87.62679756,216,212,66,61,135,147,428,282,127
751,TA1307000130,Morgan St & Polk St,41.871737,-87.65103,731,761,211,215,507,539,1492,1046,426
752,TA1307000131,Wabash Ave & Wacker Pl,41.886875,-87.62603,646,627,248,238,344,300,1273,644,486
753,TA1307000134,Wilton Ave & Belmont Ave,41.94018,-87.65304,1228,1205,478,480,721,707,2433,1428,958
754,TA1307000136,Clark St & Wellington Ave,41.93649682,-87.64753866,795,839,258,265,521,561,1634,1082,523
755,TA1307000138,Lincoln Ave & Roscoe St,41.94379282,-87.67122054,483,486,177,179,294,297,969,591,356
756,TA1307000139,MLK Jr Dr & 29th St,41.842052,-87.617,322,282,105,92,209,186,604,395,197
757,TA1307000140,Western Ave & Leland Ave,41.9663998,-87.68870428,396,408,196,192,193,202,804,395,388
758,TA1307000142,Clark St & Drummond Pl,41.931188,-87.64434717,915,933,363,361,530,546,1848,1076,724
759,TA1307000143,Sedgwick St & Schiller St,41.907626,-87.638566,213,214,81,82,130,129,427,259,163
760,TA1307000144,Wolcott (Ravenswood) Ave & Montrose Ave,41.961406,-87.676169,229,240,114,117,111,114,469,225,231
761,TA1307000149,Ravenswood Ave & Irving Park Rd,41.95469,-87.67393,268,313,113,120,150,185,581,335,233
762,TA1307000150,Pine Grove Ave & Waveland Ave,41.94947274,-87.64645278,768,778,254,251,498,509,1546,1007,505
763,TA1307000151,Wells St & Hubbard St,41.889906,-87.634266,1391,1381,585,578,778,777,2772,1555,1163
764,TA1307000153,Emerald Ave & 28th St,41.843599,-87.6454665,173,177,31,36,133,135,350,268,67
765,TA1307000156,Lincoln Ave & Sunnyside Ave,41.96306067,-87.68481717,272,268,98,94,166,164,540,330,192
766,TA1307000158,Damen Ave & Leland Ave,41.967094,-87.679028,280,252,132,126,144,124,532,268,258
767,TA1307000159,Paulina St & 18th St,41.857901,-87.668745,240,228,91,89,145,131,468,276,180
768,TA1307000160,Prairie Ave & Garfield Blvd,41.794853,-87.618691,99,70,40,26,53,41,169,94,66
769,TA1307000161,Halsted St & 37th St,41.827059,-87.64572,43,48,32,31,10,16,91,26,63
770,TA1307000163,Clifton Ave & Armitage Ave,41.918216,-87.656936,603,636,215,220,381,412,1239,793,435
771,TA1307000164,Woodlawn Ave & 55th St,41.795264,-87.596471,570,482,115,90,444,381,1052,825,205
772,TA1307000166,Halsted St & Willow St,41.913865,-87.648755,583,589,217,217,363,364,1172,727,434
773,TA1308000001,Theater on the Lake,41.926277,-87.630834,1141,1155,228,232,825,843,2296,1668,460
774,TA1308000002,Greenwood Ave & 47th St,41.809835,-87.599383,102,103,51,49,49,48,205,97,100
775,TA1308000005,Leavitt St & North Ave,41.91050937,-87.68238902,307,310,121,119,181,189,617,370,240
776,TA1308000006,Damen Ave & Grand Ave,41.891398,-87.6768445,345,327,180,180,157,136,672,293,360
777,TA1308000007,MLK Jr Dr & 47th St,41.809851,-87.616279,24,29,10,11,13,18,53,31,21
778,TA1308000009,Shore Dr & 55th St,41.7952285,-87.58082133,595,589,155,153,413,410,1184,823,308
779,TA1308000012,Montrose Harbor,41.96394817,-87.638173,577,543,147,132,350,330,1120,680,279
780,TA1308000013,Halsted St & Archer Ave,41.847203,-87.646795,145,140,46,45,93,85,285,178,91
781,TA1308000014,Normal Ave & Archer Ave,41.849527,-87.640591,62,51,16,15,42,31,113,73,31
782,TA1308000019,Racine Ave & Belmont Ave,41.9396905,-87.65887717,584,590,257,255,319,330,1174,649,512
783,TA1308000021,Winthrop Ave & Lawrence Ave,41.968812,-87.657659,327,315,144,134,183,176,642,359,278
784,TA1308000022,Pine Grove Ave & Irving Park Rd,41.954383,-87.648043,704,677,246,239,440,421,1381,861,485
785,TA1308000023,Cottage Grove Ave & 43rd St,41.81654633,-87.60655267,66,55,24,21,42,34,121,76,45
786,TA1308000026,Wentworth Ave & 24th St (Temp),41.85007191,-87.63232422,97,121,23,20,60,94,218,154,43
787,TA1308000029,Stetson Ave & South Water St,41.886835,-87.62232,783,591,307,247,448,322,1374,770,554
788,TA1308000031,Logan Blvd & Elston Ave,41.929465,-87.684158,371,410,208,202,154,197,781,351,410
789,TA1308000035,Lake Park Ave & 47th St,41.809443,-87.591875,138,142,49,53,78,81,280,159,102
790,TA1308000036,Indiana Ave & 31st St,41.838842,-87.621857,143,131,33,31,107,93,274,200,64
791,TA1308000038,Cottage Grove Ave & Oakwood Blvd,41.82291733,-87.6070695,66,76,18,19,38,45,142,83,37
792,TA1308000043,Halsted St & 35th St,41.83067465,-87.6471163,93,90,47,47,42,40,183,82,94
793,TA1308000045,Wallace St & 35th St,41.83101433,-87.64118358,73,63,24,21,47,41,136,88,45
794,TA1308000046,Morgan St & 31st St,41.8378,-87.65114,258,263,133,131,121,126,521,247,264
795,TA1308000047,Southport Ave & Clark St,41.957081,-87.664199,147,142,41,40,103,98,289,201,81
796,TA1308000049,Wells St & Evergreen Ave,41.90664467,-87.63518017,1051,1048,423,430,603,598,2099,1201,853
797,TA1308000050,Wells St & Concord Ln,41.912133,-87.634656,1692,1679,618,611,1040,1041,3371,2081,1229
798,TA1309000001,Halsted St & Maxwell St,41.864883,-87.647071,436,460,176,181,244,266,896,510,357
799,TA1309000002,Michigan Ave & Jackson Blvd,41.87785,-87.62408,547,490,176,152,310,292,1037,602,328
800,TA1309000003,Western Ave & 24th St,41.84847784,-87.68517053,92,89,60,55,31,34,181,65,115
801,TA1309000004,LaSalle St & Jackson Blvd,41.878166,-87.631929,882,875,362,342,494,521,1757,1015,704
802,TA1309000006,Larrabee St & Armitage Ave,41.91812717,-87.6437775,543,530,162,162,369,359,1073,728,324
803,TA1309000007,Franklin St & Monroe St,41.880317,-87.635185,995,934,509,461,468,465,1929,933,970
804,TA1309000008,Franklin St & Adams St (Temp),41.87957267,-87.635048,698,709,321,324,353,354,1407,707,645
805,TA1309000010,Wabash Ave & 9th St,41.87078524,-87.62577879,896,907,348,345,499,507,1803,1006,693
806,TA1309000011,Ellis Ave & 58th St,41.788746,-87.601334,593,609,79,78,510,525,1202,1035,157
807,TA1309000012,Damen Ave & Sunnyside Ave,41.96325,-87.679258,189,175,72,71,117,103,364,220,143
808,TA1309000014,Clark St & Leland Ave,41.967096,-87.667429,389,383,149,151,233,227,772,460,300
809,TA1309000015,Leavitt St & Lawrence Ave,41.968885,-87.684001,134,105,47,39,86,64,239,150,86
810,TA1309000018,Ravenswood Ave & Berteau Ave,41.957921,-87.673567,233,236,83,81,150,153,469,303,164
811,TA1309000019,Lakeview Ave & Fullerton Pkwy,41.925858,-87.638973,983,941,308,307,632,596,1924,1228,615
812,TA1309000021,Paulina St & Montrose Ave,41.961507,-87.671387,179,143,52,49,122,89,322,211,101
813,TA1309000023,Sheffield Ave & Wrightwood Ave,41.928712,-87.653833,693,678,250,243,425,425,1371,850,493
814,TA1309000024,Clark St & Schiller St,41.90815567,-87.63156883,1096,1013,386,372,684,623,2109,1307,758
815,TA1309000025,Halsted St & Roscoe St,41.94367,-87.64895,1025,1064,442,449,558,593,2089,1151,891
816,TA1309000026,Lincoln Ave & Belle Plaine Ave,41.956004,-87.680161,274,280,104,109,161,167,554,328,213
817,TA1309000027,Sheridan Rd & Buena Ave,41.95850408,-87.65497804,427,421,186,187,238,226,848,464,373
818,TA1309000029,Leavitt St & Armitage Ave,41.91772333,-87.68251417,294,294,154,154,136,137,588,273,308
819,TA1309000030,Southport Ave & Clybourn Ave,41.92077733,-87.66370667,577,600,295,294,267,297,1177,564,589
820,TA1309000032,Elston Ave & Wabansia Ave,41.912919,-87.664169,184,189,89,89,93,100,373,193,178
821,TA1309000033,Sheffield Ave & Webster Ave,41.92154,-87.653818,771,790,293,284,457,489,1561,946,577
822,TA1309000035,Clark St & Winnemac Ave,41.97334764,-87.66785547,666,673,296,302,359,347,1339,706,598
823,TA1309000036,Burling St & Diversey Pkwy,41.93314,-87.64776,635,663,218,219,415,437,1298,852,437
824,TA1309000037,Kimbark Ave & 53rd St,41.799568,-87.594747,648,642,167,162,470,466,1290,936,329
825,TA1309000039,DuSable Lake Shore Dr & Diversey Pkwy,41.932588,-87.636427,637,616,177,157,418,429,1253,847,334
826,TA1309000041,Sheridan Rd & Lawrence Ave,41.96946267,-87.6547315,337,338,129,127,198,207,675,405,256
827,TA1309000042,Lincoln Ave & Belmont Ave,41.939247,-87.66832883,522,559,227,229,285,320,1081,605,456
828,TA1309000043,Southport Ave & Irving Park Rd,41.954177,-87.664358,460,439,157,153,278,266,899,544,310
829,TA1309000049,DuSable Lake Shore Dr & Belmont Ave,41.940775,-87.639192,767,777,256,251,470,487,1544,957,507
830,TA1309000050,Lincoln Ave & Addison St,41.946176,-87.673308,160,154,63,53,88,98,314,186,116
831,TA1309000051,Commercial Ave & 83rd St,41.744615,-87.551208,8,7,4,5,4,1,15,5,9
832,TA1309000053,Cottage Grove Ave & 47th St,41.809855,-87.606755,86,74,27,28,55,46,160,101,55
833,TA1309000055,Emerald Ave & 31st St,41.8381435,-87.64509617,324,338,124,123,197,202,662,399,247
834,TA1309000058,Lincoln Ave & Fullerton Ave,41.92416103,-87.64638036,812,823,327,332,479,478,1635,957,659
835,TA1309000059,Racine Ave & Wrightwood Ave,41.928887,-87.658971,406,415,115,116,287,294,821,581,231
836,TA1309000061,Halsted St & Wrightwood Ave,41.929131,-87.64910733,982,954,351,345,616,597,1936,1213,696
837,TA1309000063,Lake Park Ave & 56th St,41.793242,-87.587782,427,426,111,105,302,315,853,617,216
838,TA1309000064,Wolcott Ave & Polk St,41.871262,-87.673688,722,628,268,241,451,383,1350,834,509
839,TA1309000066,Ravenswood Ave & Lawrence Ave,41.96909,-87.674237,770,761,321,321,442,434,1531,876,642
840,TA1309000067,Cottage Grove Ave & 51st St,41.803038,-87.606615,56,47,20,17,35,28,103,63,37
841,Wilton Ave & Diversey Pkwy - Charging,Wilton Ave & Diversey Pkwy - Charging,41.932418,-87.652705,17,19,6,6,11,13,36,24,12
842,WL-008,Clinton St & Roosevelt Rd,41.86711778,-87.64108796,353,381,166,169,168,194,734,362,335
843,WL-011,Jefferson St & Monroe St,41.88032963,-87.64274597,420,419,152,154,264,258,839,522,306
844,WL-012,Clinton St & Washington Blvd,41.88338,-87.64117,1690,1720,775,777,904,930,3410,1834,1552
